The Haunted Sandwich
An Interactive Fiction by Y'Gael of Atrii
Release 1 / Serial number 201126 / Inform 7 build 6M62 (I6/v6.33 lib 6/12N) SD

Kitchen
You can see a mystery jar (empty), a slate, a piece of chalk, A bottle of whiskey and a cup (in which is water) here.

>ACTIONS
Actions listing on.

>smell jar
[smelling the mystery jar]
You smell nothing unexpected.
[smelling the mystery jar - succeeded]

* * *

>ACTIONS
Actions listing on.

>OPEN MYSTERY JAR
[opening the mystery jar]
It isn't something you can open.
[opening the mystery jar - failed the can't open unless openable rule]

* * *

The Haunted Sandwich
An Interactive Fiction by Y'Gael of Atrii
Release 1 / Serial number 201126 / Inform 7 build 6M62 (I6/v6.33 lib 6/12N) SD

Kitchen
You can see a mystery jar (empty), a slate, a piece of chalk, A bottle of whiskey and a cup (in which is water) here.

>draw jar
That's not a verb I recognise.

* * *

>imbibe wiskey
That's not a verb I recognise.

* * *

>i
You are carrying:
  an empty glass bottle
  A bottle of whiskey

>take chalk
Taken.

>i
You are carrying:
  a chalk
  an empty glass bottle

* * *

>ACTIONS
Actions listing on.

* * *

>smell jar
[smelling the mystery jar]
You smell nothing unexpected.
[smelling the mystery jar - succeeded]

>open mystery jar
[opening the mystery jar]
It isn't something you can open.
[opening the mystery jar - failed the can't open unless openable rule]

* * *

>ACTIONS
Actions listing on.

>drink whiskey
[drinking the whiskey]
[(1) imbibing the whiskey]
You down the whiskey in one gulp.
20[(1) imbibing the whiskey - succeeded]

[drinking the whiskey - failed]

19

>i
[taking inventory]
You are carrying nothing.

[taking inventory - succeeded]

18

>l
[looking]
Kitchen
You can see a mystery jar (empty), a slate, a piece of chalk and a cup (empty) here.

[looking - succeeded]

17

>i
[taking inventory]
You are carrying nothing.

[taking inventory - succeeded]

16

* * *

>wait
Time passes.

6

>wait
Time passes.

5

>wait
Time passes.

4

>wait
Time passes.

3

>wait
Time passes.

2

>wait
Time passes.

1

>wait
Time passes.

0

>wait
Time passes.

* * *

The Haunted Sandwich
An Interactive Fiction by Y'Gael of Atrii
Release 1 / Serial number 201126 / Inform 7 build 6M62 (I6/v6.33 lib 6/12N) SD

Kitchen
You can see a mystery jar (empty), a slate, a piece of chalk, A bottle of whiskey and a cup (in which is water) here.

>take whiskey
Taken.

>drink whiskey
You take a hearty swig of whiskey.

* * *

>take whiskey
Taken.

>examine whiskey
You see nothing special about Whiskey.

* * *

The Haunted Sandwich
An Interactive Fiction by Y'Gael of Atrii
Release 1 / Serial number 201126 / Inform 7 build 6M62 (I6/v6.33 lib 6/12N) SD

Kitchen
You can see a mystery jar (empty), a slate, a piece of chalk, A bottle of whiskey and a cup (in which is water) here.

>examine whiskey
You see nothing special about the whiskey.

* * *

The Haunted Sandwich
An Interactive Fiction by Y'Gael of Atrii
Release 1 / Serial number 201126 / Inform 7 build 6M62 (I6/v6.33 lib 6/12N) SD

Kitchen
You can see a mystery jar (empty), a slate, a piece of chalk, A bottle of whiskey and a cup (in which is water) here.

>n
Living Room

>s
Kitchen
You can see a mystery jar (empty), a slate, a chalk and a glass bottle (in which is a quantity of whiskey) here.

>n
Living Room

>take whiskey
You can't see any such thing.

>drink whiskey
You can't see any such thing.

>s
Kitchen
You can see a mystery jar (empty), a slate, a chalk and a glass bottle (in which is a quantity of whiskey) here.

>drink whiskey
(first taking the whiskey.)

You down the whiskey in one gulp.

>i
You are carrying:
  a glass bottle
    a quantity of whiskey

* * *

The Haunted Sandwich
An Interactive Fiction by Y'Gael of Atrii
Release 1 / Serial number 201126 / Inform 7 build 6M62 (I6/v6.33 lib 6/12N) SD

Kitchen
You can see a mystery jar (empty), a slate, a piece of chalk, A bottle of whiskey and a cup (in which is water) here.

>i
You are carrying nothing.

>drink whiskey
(first taking the whiskey.)

You down the whiskey in one gulp.

>i
You are carrying:
  a glass bottle

* * *

The Haunted Sandwich
An Interactive Fiction by Y'Gael of Atrii
Release 1 / Serial number 201126 / Inform 7 build 6M62 (I6/v6.33 lib 6/12N) SD

Kitchen
You can see a mystery jar (empty), a slate, a piece of chalk, A bottle of whiskey and a cup (in which is water) here.

>drink water
(first taking the water.)

You down the water in one gulp.

>l
Kitchen
You can see a mystery jar (empty), a slate, a piece of chalk and the glass bottle (in which is a quantity of whiskey) here.

* * *

>drink water
(first taking the water.)

You down the water in one gulp.

>i
You are carrying nothing.

* * *

The Haunted Sandwich
An Interactive Fiction by Y'Gael of Atrii
Release 1 / Serial number 201126 / Inform 7 build 6M62 (I6/v6.33 lib 6/12N) SD

Kitchen
You can see a mystery jar (empty), a slate, a piece of chalk, A bottle of whiskey and a cup (in which is water) here.

>l
Kitchen
a bottle of whiskey

You can also see a mystery jar (empty), a slate, a piece of chalk and a cup (empty) here.

>l
Kitchen
a bottle of whiskey

You can also see a mystery jar (empty), a slate, a piece of chalk and a cup (empty) here.

>take whiskey
Taken.

>i
You are carrying:
  a whiskey