Hallways
An Interactive Fiction
Release 1 / Serial number 201124 / Inform 7 build 6M62 (I6/v6.33 lib 6/12N) SD

You are in a dream; not yours, but someone else's. There is a pair of glasses and a short bookcase here.

>take glasses
Taken.

>wear glasses
You put on the pair of glasses.

>look
Ordinary Room
This is a very plain room about 14 foot square. The walls are white.

You can see a short bookcase (on which is a white book) here.

You can see no obvious exits.

* * *

Hallways
An Interactive Fiction
Release 1 / Serial number 201124 / Inform 7 build 6M62 (I6/v6.33 lib 6/12N) SD

You are in a dream; not yours, but someone else's. There is a pair of glasses and a short bookcase here.

>wear glasses
(first taking the pair of glasses)
You put on the pair of glasses.

>look
Ordinary Room
This is a very plain room about 14 foot square. The walls are white.

You can see a short bookcase (on which is a white book) here.

You can see no obvious exits.

>w
test

>e
test

* * *

>wear glasses
(first taking the pair of glasses)
You put on the pair of glasses.

>take off glasses
You take off the pair of glasses.

>wear glasses
You put on the pair of glasses.

>look
The glasses blur your vision. You must take them off first.

>look at bookcase
Everything is blurry, except for a single white book on the bookcase.

* * *

>wear glasses
(first taking the pair of glasses)
You put on the pair of glasses.

>look at books
Everything is blurry except for a single white book on the bookcase.

>remove glasses
You take off the pair of glasses.

>examine bookcase
There are many books on the bookcase, but most of them are uninteresting. 

On the short bookcase is a white book.

>take white book
Taken.

>read book
The first page says: "YOU ARE READING THIS BOOK."

>wait
The next page says: "YOU ARE STILL READING THIS BOOK."

>wait
The next page says: "YOU ARE STILL READING THIS BOOK."

>wait
The next page says: "YOU ARE STILL READING THIS BOOK."

All this reading is making you tired.

>wait
The next page says: "YOU CONTINUE TO READ THIS BOOK."

The more you read, the more tired you feel.

>wait
The next page says: "YOU ARE READING THIS BOOK."

You feel drained. It's getting harder to understand the words.

>wait
The next page says: "YOU ARE STILL READING THIS BOOK."

In fact, its getting harder to think of anything at all.

>wait
The next page says: "YOU CONTINUE TO READ THIS BOOK."

You're exhausted. You feel as if you might pass out soon.

>wait
The last page says: "YOU HAVE FINISHED...

The book drops from your hand as you fall asleep mid-sentence, sinking into warm darkness. Time passes, and you awake lying face-down on the carpet in an unfamiliar hallway. There is something strange about this place, but you can't quite explain it. You also sense that something important has changed. You feel a vague but persistent tension growing in the back of your mind. You slowly stand, and after a brief dizzy spell, regain your footing.

Hallway
This is a long hallway that seems to stretch endlessly in either direction.  It is reminiscent of the halls of a fancy hotel; identical doors are spaced regularly along the walls on either side, each of which are outfitted with a black box above the handle designed to accept a key card. The walls are papered with a rich navy and powder-blue damask pattern, and a tightly knitted carpet frames the passage, tracing muted grey and gold stripes down its length. The air feels unnaturally still.

You can go north, south, east and west from here.

* * *

>wear glasses
(first taking the pair of glasses)
You put on the pair of glasses.

>examine bookcase
Everything is blurry except for a single white book on the bookcase.

>take off glasses
You take off the pair of glasses.

>read book
The first page says: "YOU ARE READING THIS BOOK."

>wait
The next page says: "YOU ARE READING THIS BOOK."

>wait
The next page says: "YOU ARE READING THIS BOOK."

>west
The next page says: "YOU ARE READING THIS BOOK."

All this reading is making you tired.

>w
The next page says: "YOU ARE READING THIS BOOK."

The more you read, the more tired you feel.

>e
The next page says: "YOU ARE READING THIS BOOK."

You feel drained. It's getting harder to understand the words.

>w
The next page says: "YOU ARE READING THIS BOOK."

In fact, its getting harder to think of anything at all.

>e
The next page says: "YOU ARE READING THIS BOOK."

You're exhausted. You feel as if you might pass out soon.

>n
The last page says: "YOU HAVE FINISHED...

The book drops from your hand as you fall asleep mid-sentence, sinking into warm darkness. Time passes, and you awake lying face-down on the carpet in an unfamiliar hallway. There is something strange about this place, but you can't quite explain it. You also sense that something important has changed. You feel a vague but persistent tension growing in the back of your mind. You slowly stand, and after a brief dizzy spell, regain your footing.

Hallway
This is a long hallway that seems to stretch endlessly in either direction.  It is reminiscent of the halls of a fancy hotel; identical doors are spaced regularly along the walls on either side, each of which are outfitted with a black box above the handle designed to accept a key card. The walls are papered with a rich navy and powder-blue damask pattern, and a tightly knitted carpet frames the passage, tracing muted grey and gold stripes down its length. The air feels unnaturally still.

You can go north, south, east and west from here.

* * *

>wear glasses
(first taking the pair of glasses)
You put on the pair of glasses.

>examine books
Everything is blurry except for a single white book on the bookcase.

>remove glasses
You take off the pair of glasses.

>read book
The first page says: "YOU ARE READING THIS BOOK."

>read
What do you want to read?

>book
You're reading the book right now...
The next page says: "YOU ARE READING THIS BOOK."

>read book
You're reading the book right now...
The next page says: "YOU ARE READING THIS BOOK."

>w
You're reading the book right now...
The next page says: "YOU ARE READING THIS BOOK."

* * *

>wear glasses
(first taking the pair of glasses)
You put on the pair of glasses.

>look books
Everything is blurry except for a single white book on the bookcase.

>remove glasses
You take off the pair of glasses.

* * *

>read
What do you want to read?

>book
Youreading the book right now...
The next page says: "YOU ARE READING THIS BOOK."

* * *

Hallways
An Interactive Fiction
Release 1 / Serial number 201124 / Inform 7 build 6M62 (I6/v6.33 lib 6/12N) SD

You are in a dream; not yours, but someone else's. There is a pair of glasses and a short bookcase here.

>look
Ordinary Room
This is a very plain room about 14 foot square. The walls are white.

You can see a pair of glasses and a short bookcase here.

You can see no obvious exits.

>wear glasses
(first taking the pair of glasses)
You put on the pair of glasses.

>take off glasses
The glasses blur your vision. You must take them off first.

>look
Ordinary Room
This is a very plain room about 14 foot square. The walls are white.

You can see a short bookcase here.

You can see no obvious exits.

>wear glasses
The glasses blur your vision. You must take them off first.

>look
Ordinary Room
This is a very plain room about 14 foot square. The walls are white.

You can see a short bookcase here.

You can see no obvious exits.

>ACTIONS
Actions listing on.

>take off glasses
[taking off the pair of glasses]
The glasses blur your vision. You must take them off first.
[taking off the pair of glasses - failed]

* * *

>look
Ordinary Room
This is a very plain room about 14 foot square. The walls are white.

You can see a pair of glasses and a short bookcase here.

You can see no obvious exits.

>take bookcase
That's fixed in place.

>examine bookcase
  There are many books on the bookcase, but nothing stands out to you at the moment.

>examine books
  There are many books on the bookcase, but nothing stands out to you at the moment.

>wear glasses
(first taking the pair of glasses)
You put on the pair of glasses.

>look
The glasses blur your vision.

>look at bookcase
Everything is blurry except for a single white book on the bookcase.

>take book
The glasses blur your vision.

>remove glasses
You take off the pair of glasses.

>examine bookcase
There are many books on the bookcase, but only the white one interests you. 

On the short bookcase is a white book.

* * *

Hallways
An Interactive Fiction
Release 1 / Serial number 201124 / Inform 7 build 6M62 (I6/v6.33 lib 6/12N) SD

You are in a dream; not yours, but someone else's. There is a pair of glasses and a short bookcase here.

>ACTIONS
Actions listing on.

>wear glasses
[wearing the pair of glasses]
(first taking the pair of glasses)
[(1) taking the pair of glasses - silently]
[(1) taking the pair of glasses - silently - succeeded]

You put on the pair of glasses.
[wearing the pair of glasses - succeeded]

>take off glasses
[taking off the pair of glasses]
The glasses blur your vision. You must take them off first.
[taking off the pair of glasses - failed]

* * *

Hallways
An Interactive Fiction
Release 1 / Serial number 201124 / Inform 7 build 6M62 (I6/v6.33 lib 6/12N) SD

You are in a dream; not yours, but someone else's. There is a pair of glasses and a short bookcase here.

>examine bookcase
 There are many books on the bookcase, but nothing stands out to you at the moment.

>examine books
You can't see any such thing.

* * *

>examine bookcase
 There are many books on the bookcase, but nothing stands out to you at the moment.

>wear glasses
(first taking the pair of glasses)
You put on the pair of glasses.

>look at bookcase
Everything is blurry except for a single white book on the bookcase.

>look at books
The glasses blur your vision.

* * *

Hallways
An Interactive Fiction
Release 1 / Serial number 201124 / Inform 7 build 6M62 (I6/v6.33 lib 6/12N) SD

You are in a dream; not yours, but someone else's. There is a pair of glasses and a short bookcase here.

>take books
None of them stand out to you, so you leave them alone.

* * *

Hallways
An Interactive Fiction
Release 1 / Serial number 201124 / Inform 7 build 6M62 (I6/v6.33 lib 6/12N) SD

You are in a dream; not yours, but someone else's. There is a pair of glasses and a short bookcase here.

>examine books
There are many books on the bookcase, but nothing stands out to you at the moment.

>take books
There are many books on the bookcase, but nothing stands out to you at the moment.

* * *

Hallways
An Interactive Fiction
Release 1 / Serial number 201124 / Inform 7 build 6M62 (I6/v6.33 lib 6/12N) SD

You are in a dream; not yours, but someone else's. There is a pair of glasses and a short bookcase here.

>examine glasses
It is a pair of half-moon spectacles. They glow faintly, as if by magic.

>take glasses
Taken.

>examine bookshelf
You can't see any such thing.

>examine bookcase
 There are many books on the bookcase, but nothing stands out to you at the moment.

>take book
You can't see any such thing.

>examine books
 There are many books on the bookcase, but nothing stands out to you at the moment.