Hallways
An Interactive Fiction
Release 1 / Serial number 201002 / Inform 7 build 6M62 (I6/v6.33 lib 6/12N) SD

Hallway
This is a long hallway that seems to stretch endlessly in either direction.  It is reminiscent of the halls of a fancy hotel; identical doors are spaced regularly along the walls on either side, each of which are outfitted with a black box above the handle designed to accept a key card. The walls are papered with a rich navy and powder-blue damask pattern, and a tightly knitted carpet frames the passage, tracing muted grey and gold stripes down its length. The air feels unnaturally still.

A steel knife is embedded in the wall nearby.

A torn piece of wall paper hangs limply from the wall.

You can also see an east door here.

You can go north, south, east through the east door (closed) and west from here.

* * *

>i
You are carrying:
  a box
  a solutions manual

>take box
Taken.

>i
You are carrying:
  two boxes
  a solutions manual

* * *

>wear hat
You put on the Pointy Hat of Liminal Transgression.

* * *

>xyzzy
That's not a verb I recognise.

>take cage
Taken.

>examine cage
You see nothing special about the wicker cage.

* * *

>look at east door
You see nothing special about the east door.

* * *

>east
Emerald Room
The door opens to a room in darkness. You step into the darkness and sense that there is something nearby.

>take something
You can't see any such thing.

>e
You can't go that way.

>w
Hallway
You are in a long hallway.  Identifcal doors are spaced regularly along the walls on either side. The air feels unnaturally still here.

There is a door to the east.

There is a door to the west.

>w
Nothing Room
The door opens to a room in darkness. You step into the darkness and sense that there is nothing nearby.

>examine nothing
You can't see any such thing.

* * *

>e
Hallway
You are standing in the middle a long hallway that seems to stretch endlessly in either direction.  It is reminiscent of the halls that one might see in a fancy hotel; identical doors are spaced regularly along the walls on either side, each of which are outfitted with a black box above the handle designed to accept a key card. The walls are papered with a rich navy and powder-blue damask pattern, and a tightly knitted carpet frames the passage, tracing muted grey and gold stripes down its length.  The air feels unnaturally still here.

You can go north, south, east and west from here.

>w
empty corridor
This is a long section of empty hallway. Further west, you see that the hallway diverges into similar looking corridors with no doors, no furniture and no ornamentation. You sense that if you keep going to the west, you may become lost. The wallpaper is yellow here.

You can go east to the Hallway and west from here.

>w
Indistinguishable Corridors
You are in an empty corridor like many others. The wallpaper is yellow here.

These hallways are identical. There are exits here, but you have lost your sense of direction.

>n
You can't go that way.

* * *

>w
Indistinguishable Corridors
You are in an empty corridor like many others. The wallpaper is yellow here.

These hallways are identical. There are exits here, but you have lost your sense of direction.

>w
You try going west, but there isn't an exit there.

>w
You try going west but there isn't an exit there. You are beginning to feel lost.

>w
You try going west but there isn't an exit there. You are beginning to panic.

>w
You try going west but there isn't an exit there. You are beginning to panic.

>w
You try going west, but there isn't an exit there.

>w
You try going west, but there isn't an exit there.

>s
Indistinguishable Corridors
You are in an empty corridor like many others. The wallpaper is yellow here.

These hallways are identical. There are exits here, but you have lost your sense of direction.

>w
Indistinguishable Corridors
You are in an empty corridor like many others. The wallpaper is yellow here.

These hallways are identical. There are exits here, but you have lost your sense of direction.

>w
Indistinguishable Corridors
You are in an empty corridor like many others. The wallpaper is yellow here.

These hallways are identical. There are exits here, but you have lost your sense of direction.

* * *

>w
You try going west, but there isn't an exit there.

>s
You try going south, but there isn't an exit there.

* * *

>w
empty corridor
This is a long section of empty hallway. Further west, you see that the hallway diverges into similar looking corridors with no doors, no furniture and no ornamentation. You sense that if you keep going to the west, you may become lost. The wallpaper is yellow here.

You can go east to the Hallway and west from here.

>e
test room
You can see the inventory expert here.

You can go west to the test lobby from here.

>open stove
You open the stove, revealing a plastic turkey.

>take turkey
Taken.

>examine turkey
Some things are exactly as they seem.

* * *

>e
test room
You can see the inventory expert here.

You can go west to the test lobby from here.

>e
Something tells you  (put conditional here later)
Hallway
You are standing in the middle a long hallway that seems to stretch endlessly in either direction.  It is reminiscent of the halls that one might see in a fancy hotel; identical doors are spaced regularly along the walls on either side, each of which are outfitted with a black box above the handle designed to accept a key card. The walls are papered with a rich navy and powder-blue damask pattern, and a tightly knitted carpet frames the passage, tracing muted grey and gold stripes down its length.  The air feels unnaturally still here.

You can go north, south and west to the Old Mall from here.

>n
Something tells you  (put conditional here later)
Hallway
You are standing in the middle a long hallway that seems to stretch endlessly in either direction.  It is reminiscent of the halls that one might see in a fancy hotel; identical doors are spaced regularly along the walls on either side, each of which are outfitted with a black box above the handle designed to accept a key card. The walls are papered with a rich navy and powder-blue damask pattern, and a tightly knitted carpet frames the passage, tracing muted grey and gold stripes down its length.  The air feels unnaturally still here.

You can go north, south to the Hallway, east and west from here.

>w
Something tells you  (put conditional here later)
Empty Corridor
This is a long section of empty hallway. Further west, you see that the hallway diverges into similar looking corridors with no doors, no furniture and no ornamentation. You sense that if you keep going to the west, you may become lost. The wallpaper is yellow here.

You can go east to the Hallway and west from here.

>d
Something tells you  (put conditional here later)
There is something terrible about the staircase that chills you to the core. As you take your first step down, you are overcome with waves of fear and weakness. Unnameable images flash through your mind. You gasp for breath, but there is no air. Darkness consumes you as your body falls limp into the void.

Something tells you  (put conditional here later)
Walls
You are standing on a slab of concrete that is four foot square. Around you on every side are grey brick walls that stretch upward indefinitely. Your fear resolves into a grim sense of familiarity, and a heavy burden lifts from your shoulders. You feel oddly at peace.

You can see the walls here.

You can see no obvious exits.

>n
Something tells you  (put conditional here later)
You can't go that way.

>w
Something tells you  (put conditional here later)
You can't go that way.

>n
Something tells you  (put conditional here later)
You can't go that way.

* * *

>e
test room
You can see the inventory expert here.

You can go west to the test lobby from here.

>ACTIONS
Actions listing on.

>W
[going west]

test lobby
You can go east to the test room from here.

[going west - succeeded]

>E
[going east]

test room
You can see the inventory expert here.

You can go west to the test lobby from here.

[going east - succeeded]

* * *

>w
empty corridor
This is a long section of empty hallway. Further west, you see that the hallway diverges into similar looking corridors with no doors, no furniture and no ornamentation. You sense that if you keep going to the west, you may become lost. The wallpaper is yellow here.

You can go east to the Hallway and west from here.

>n
Hallway End
The hallway seems to end here. There are doors to the north, east, and west. There is something deeply disquieting about the doorway to the north, ordinary as it appears.

>w
You can't go that way.

>e
Outside Room
Opening the door reveals what at first looks to be a wide outdoor space filled with shrubs and grasses. A fog hangs in the air above you, obscuring the view upward. The illusion is broken by many white pillars holding up what must be a distant cieling. In the east corner of this large room is a small plastic house.

>enter house
You can't see any such thing.

>w
Hallway End
The hallway seems to end here. There are doors to the north, east, and west. There is something deeply disquieting about the doorway to the north, ordinary as it appears.

>e
Outside Room
Opening the door reveals what at first looks to be a wide outdoor space filled with shrubs and grasses. A fog hangs in the air above you, obscuring the view upward. The illusion is broken by many white pillars holding up what must be a distant cieling. In the east corner of this large room is a small plastic house.

>e
Play House
This house would be very cozy if it weren't sized for children. There is a kitchenette complete with a table, plastic stove and refrigerator, and a living room which contains a chair, a small throw rug, and a well-drawn picture of a television. There are many clocks drawn on the walls in crayon, each telling different times.

A little plastic stove that opens and closes.

A plastic refrigerator that opens and closes.

You can also see a table (on which is a plastic toaster) here.

>examien television
That's not a verb I recognise.

>examine television
You watch an imaginary news program on the imaginary television for a while before becoming bored and giving up.

>examine refrigerator
You see nothing special about the refrigerator.

>w
Outside Room
Opening the door reveals what at first looks to be a wide outdoor space filled with shrubs and grasses. A fog hangs in the air above you, obscuring the view upward. The illusion is broken by many white pillars holding up what must be a distant cieling. In the east corner of this large room is a small plastic house.

>n
You can't go that way.

>w
Hallway End
The hallway seems to end here. There are doors to the north, east, and west. There is something deeply disquieting about the doorway to the north, ordinary as it appears.

>s
Yet More Hallway
You are in a long hallway.  Identical doors are spaced regularly along the walls on either side. Each door has a sign beside it bearing a room number. There are two doors to your immediate left and right (east and west). The walls are papered. You can see the end of the hallway to the north.

>e
Extraordinary Room
This room is completely dark.

You can see something here.

>w
Yet More Hallway
You are in a long hallway.  Identical doors are spaced regularly along the walls on either side. Each door has a sign beside it bearing a room number. There are two doors to your immediate left and right (east and west). The walls are papered. You can see the end of the hallway to the north.

>s
Even More Hallway
You are in a long hallway.  Identical doors are spaced regularly along the walls on either side. Each door has a sign beside it bearing a room number. There are two doors to your immediate left and right (east and west). Near the east door, there is a spot on the wall where the wallpaper is peeling. You see a torn piece.

A neat section of the blue damask wall paper has torn, revealing a patch of yellow beneath it. You admire the torn piece briefly.

>w
Room 129
This looks like a bedroom. There is a bed, a closet, and a mirror. There is also a small night light plugged into an outlet in the wall.

 The night light is off.

You can also see a closet (closed) here.

* * *

>w
empty corridor
This is a long section of empty hallway. Further west, you see that the hallway diverges into similar looking corridors with no doors, no furniture and no ornamentation. You sense that if you keep going to the west, you may become lost. The wallpaper is yellow here.

You can go east to the Hallway and west from here.

>s
Indistinguishable Corridors
You are in an empty corridor like many others. The wallpaper is yellow here.

These hallways are identical. You panic. You can't remember how you got here.

>s
More Hallway
You are in a long hallway.  Identical doors are spaced regularly along the walls on either side.  There are two doors to your immediate left and right (east and west). The walls are papered.

>s
Hallway
You are in a long hallway.  Identical doors are spaced regularly along the walls on either side.  There are two doors to your immediate left and right (east and west). There a door to the south, and something about it is deeply disquieting, ordinary as it looks. The walls are papered. The air feels unnaturally still here.

>s
Hallway End
The hallway seems to end here. There are doors to the north, east, and west. There is something deeply disquieting about the doorway to the north, ordinary as it appears.

>w
Maze
The color of the wallpaper changes from blue to yellow around this corner, and the hallway diverges into many similar looking rooms with no furniture or ornamentation. You sense that if you keep going to the west, you may become lost.

>w
Maze
You are in a room like many others.

>s
You can't go that way.

>e
Maze
The color of the wallpaper changes from blue to yellow around this corner, and the hallway diverges into many similar looking rooms with no furniture or ornamentation. You sense that if you keep going to the west, you may become lost.

>w
Maze
You are in a room like many others.

>n
You can't go that way.

>s
You can't go that way.

* * *

>s
Indistinguishable Corridors
You are in an empty corridor like many others. The wallpaper is yellow here.

These hallways are identical. You panic. You can't remember how you got here.

>w
Utility Closet
This is a cramped, narrow room full of dirty shelves and hardware. The main light source is a pair of florescent tubes which hum unpleasantly overhead. This is augmented by the sqeaking of your feet on the linoleum tiles below. There are many odds and ends on the shelves: scraps of unused wall paper, cans of paste, rollers, an empty bottle of bleach, picture-frames, and two broken clocks. None of these seem to  be useful to you. There is also a yellowed, paint-stained sink.

>w
You can't go that way.

>se
You can't go that way.

>sw
You can't go that way.

>e
Corner
You gingerly step over the debris and shimmy yourself into the narrow east corner of the utility closet. Here the room is even dirtier. The air is thick with dust, and a musty smell pervades the air. The floor is damp, and the linoleum is warped. You are overcome with an oppressive feeling, as if the room were trying to get rid of you. To the north there is a small door, as if for a crawlspace.

>s
You can't go that way.

>w
Utility Closet
This is a cramped, narrow room full of dirty shelves and hardware. The main light source is a pair of florescent tubes which hum unpleasantly overhead. This is augmented by the sqeaking of your feet on the linoleum tiles below. There are many odds and ends on the shelves: scraps of unused wall paper, cans of paste, rollers, an empty bottle of bleach, picture-frames, and two broken clocks. None of these seem to  be useful to you. There is also a yellowed, paint-stained sink.

* * *

>w
You can't go that way.

>e
Corner
You gingerly step over the debris and shimmy yourself into the narrow east corner of the utility closet. Here the room is even dirtier. The air is thick with dust, and a musty smell pervades the air. The floor is damp, and the linoleum is warped. You are overcome with an oppressive feeling, as if the room were trying to get rid of you. To the north there is a small door, as if for a crawlspace.

>w
Utility Closet
This is a cramped, narrow room full of dirty shelves and hardware. The main light source is a pair of florescent tubes which hum unpleasantly overhead. This is augmented by the sqeaking of your feet on the linoleum tiles below. There are many odds and ends on the shelves: scraps of unused wall paper, cans of paste, rollers, an empty bottle of bleach, picture-frames, and two broken clocks. None of these seem to  be useful to you. There is also a yellowed, paint-stained sink.

>s
You can't go that way.

>n
You can't go that way.

>sw
You can't go that way.

>se
You can't go that way.

* * *

>w
empty corridor
This is a long section of empty hallway. Further west, you see that the hallway diverges into similar looking corridors with no doors, no furniture and no ornamentation. You sense that if you keep going to the west, you may become lost. The wallpaper is yellow here.

You can go east to the Hallway and west from here.

>nw
Extraordinary Room
This room is completely dark.

You can see something here.

>ne
You can't go that way.

>se
Great Hall

>ne
Ordinary Room
This room is completely dark.

You can see nothing here.

>se
You can't go that way.

>e
You can't go that way.

>w
You can't go that way.

>sw
Great Hall

>e
Lonely Room
This is a small room.

You are the only thing here.

>w
Great Hall

>w
Darkness
It is dark here.

You see nothing but the darkness.

* * *

>w
empty corridor
This is a long section of empty hallway. Further west, you see that the hallway diverges into similar looking corridors with no doors, no furniture and no ornamentation. You sense that if you keep going to the west, you may become lost. The wallpaper is yellow here.

You can go east to the Hallway and west from here.

>look
Extraordinary Room
This room is completely dark.

You can see something here.

You can go east to the Old Mall from here.

>wait
Something tells you (put something here later)
Time passes.

>take something
You can't see any such thing.

* * *

>look
Emerald Room
The door opens to a room in darkness. You step into the darkness and sense that there is something nearby.

>take uncertainty
You can't see any such thing.

* * *

>take uncertainty
Taken.

* * *

>examine door
You see nothing special about the disquieting door.

>s
(first opening the disquieting door)

Hallway End
The hallway seems to end here. There are doors to the north, east, and west. There is something deeply disquieting about the doorway to the north, ordinary as it appears.

You can see a disquieting door here.

>n
Hallway
You are in a long hallway.  Identical doors are spaced regularly along the walls on either side. Each door has a sign beside it bearing a room number. There are two doors to your immediate left and right (east and west). The walls are papered. The air feels unnaturally still here.

 

You can also see a disquieting door here.

* * *

>s
Indistinguishable Corridors
You are in an empty corridor like many others. The wallpaper is yellow here.

These hallways are identical. You panic. You have lost your sense of direction.

>s
Indistinguishable Corridors
You are in an empty corridor like many others. The wallpaper is yellow here.

These hallways are identical. You panic. You have lost your sense of direction.

>s
Hallway
You are in a long hallway.  Identical doors are spaced regularly along the walls on either side. Each door has a sign beside it bearing a room number. There are two doors to your immediate left and right (east and west). There a door to the south, and something about it is deeply disquieting, ordinary as it looks. The walls are papered. The air feels unnaturally still here.

>s
Hallway End
The hallway seems to end here. There are doors to the north, east, and west. There is something deeply disquieting about the doorway to the north, ordinary as it appears.

>n
Hallway
You are in a long hallway.  Identical doors are spaced regularly along the walls on either side. Each door has a sign beside it bearing a room number. There are two doors to your immediate left and right (east and west). There a door to the south, and something about it is deeply disquieting, ordinary as it looks. The walls are papered. The air feels unnaturally still here.

>s
Hallway End
The hallway seems to end here. There are doors to the north, east, and west. There is something deeply disquieting about the doorway to the north, ordinary as it appears.

>s
Yet More Hallway
You are in a long hallway.  Identical doors are spaced regularly along the walls on either side. Each door has a sign beside it bearing a room number. There are two doors to your immediate left and right (east and west). The walls are papered. You can see the end of the hallway to the north.

>s
Even More Hallway
You are in a long hallway.  Identical doors are spaced regularly along the walls on either side. Each door has a sign beside it bearing a room number. There are two doors to your immediate left and right (east and west). Near the east door, there is a spot on the wall where the wallpaper is peeling. You see a torn piece.

A neat section of the blue damask wall paper has torn, revealing a patch of yellow beneath it. You admire the torn piece briefly.

>e
Room 130
This room is fully furnished, with a blue fainting couch, a grandfather clock, and a coffee table. All of the furniture is made of the same dark, rich wood that can be found throughout. On the wall there is a full-sized mirror, and a large painting of a woman.

There is a grandfather clock here.

There is a fully stocked bar in the corner.

On the bar are a bottle of whiskey, a bottle of vodka, a bottle of gin and a lemon.

>examine mirror
Closer inspection reveals that it is not a mirror, but a picture of a mirror. You cannot see your reflection.

>take mirror
That's hardly portable.

>examine bar
On the bar are a bottle of whiskey, a bottle of vodka, a bottle of gin and a lemon.

>examine bottle
Which do you mean, the bottle of whiskey, the bottle of vodka or the bottle of gin?

>examine whiskey
You hate whiskey.

>examine gin
You like gin.

>take gin
Taken.

>examine clock
You can't see any such thing.

>examine grandfather-clock
You try to read the clock, but you cannot make out the time. It doesn't matter though, because the clock is stopped, and the pendulum is not swinging.

>take grandfather-clock
That's fixed in place.

>open grandfather-clock
You open the grandfather-clock, revealing a pendulum.

>take pendulum
Taken.

>examine pendulum
You see nothing special about the pendulum.

* * *

>s
Indistinguishable Corridors
You are in an empty corridor like many others. The wallpaper is yellow here.

These hallways are identical. You panic. You have lost your sense of direction.

>e
Indistinguishable Corridors
You are in an empty corridor like many others. The wallpaper is yellow here.

These hallways are identical. You panic. You have lost your sense of direction.

>w
Indistinguishable Corridors
You are in an empty corridor like many others. The wallpaper is yellow here.

These hallways are identical. You panic. You have lost your sense of direction.

>ns
That's not a verb I recognise.

>e
Indistinguishable Corridors
You are in an empty corridor like many others. The wallpaper is yellow here.

These hallways are identical. You panic. You have lost your sense of direction.

>e
Indistinguishable Corridors
You are in an empty corridor like many others. The wallpaper is yellow here.

These hallways are identical. You panic. You have lost your sense of direction.

>e
You can't go that way.

>n
Indistinguishable Corridors
You are in an empty corridor like many others. The wallpaper is yellow here.

These hallways are identical. You panic. You have lost your sense of direction.

>e
Yellow Room
These hallways are identical. You panic. You have lost your sense of direction.

* * *

>e
Records Room
This is an austere looking room with beige tile floors below and white flourescent lighting overhead. A number of file cabinets line the north and south walls. In the furthest corner is a grey metal desk with two locking drawers and a bankers lamp with a green glass shade. It is uncomfortably warm in here. In the corner, standing metal fan is noisily failing to cool it.

You can see a metal fan and some file cabinets here.

You can go east and west to the Hallway from here.

>w
Records Room
This is an austere looking room with beige tile floors below and white flourescent lighting overhead. A number of file cabinets line the north and south walls. In the furthest corner is a grey metal desk with two locking drawers and a bankers lamp with a green glass shade. It is uncomfortably warm in here. In the corner, standing metal fan is noisily failing to cool it.

You can see a metal fan and some file cabinets here.

You can go east to the Hallway and west to the The Archives from here.

>w
Nothing Room
This room is completely dark.

>examine nothing
You can't see any such thing.

>examine animal
You can't see any such thing.

* * *

>w
Records Room
This is an austere looking room with beige tile floors below and white flourescent lighting overhead. A number of file cabinets line the north and south walls. In the furthest corner is a grey metal desk with two locking drawers and a bankers lamp with a green glass shade. It is uncomfortably warm in here. In the corner, standing metal fan is noisily failing to cool it.

You can see a metal fan and some file cabinets here.

You can go east to the Hallway and west to the The Archives from here.

>s
Hallway
You are standing in the middle a long hallway that seems to stretch endlessly in either direction.  It is reminiscent of the halls that one might see in a fancy hotel; identical doors are spaced regularly along the walls on either side, each of which are outfitted with a black box above the handle designed to accept a key card. The walls are papered with a rich navy and powder-blue damask pattern, and a tightly knitted carpet frames the passage, tracing muted grey and gold stripes down its length.  The air feels unnaturally still here.

You can go north to the Hallway, south, east and west from here.

>e
Place Where you Shouldn't Be
This is a square room with little ornamentation. You feel as if you shouldn't be here.

You can see a black door here.

You can go north through the black door (closed) and west to the Hallway from here.

>examine door
It frightens you.

* * *

>e
Records Room
This is an austere looking room with beige tile floors below and white flourescent lighting overhead. A number of file cabinets line the north and south walls. In the furthest corner is a grey metal desk with two locking drawers and a bankers lamp with a green glass shade. It is uncomfortably warm in here. In the corner, standing metal fan is noisily failing to cool it.

You can see a metal fan and some file cabinets here.

You can go east and west to the Hallway from here.

>n
You can't go that way.

>w
Hallway
You are standing in the middle a long hallway that seems to stretch endlessly in either direction.  It is reminiscent of the halls that one might see in a fancy hotel; identical doors are spaced regularly along the walls on either side, each of which are outfitted with a black box above the handle designed to accept a key card. The walls are papered with a rich navy and powder-blue damask pattern, and a tightly knitted carpet frames the passage, tracing muted grey and gold stripes down its length.  The air feels unnaturally still here.

You can go north, south, east to the Records Room and west to the Narrow Corridor from here.

>e
Something tells you  (put conditional here later)
Hallway
You are standing in the middle a long hallway that seems to stretch endlessly in either direction.  It is reminiscent of the halls that one might see in a fancy hotel; identical doors are spaced regularly along the walls on either side, each of which are outfitted with a black box above the handle designed to accept a key card. The walls are papered with a rich navy and powder-blue damask pattern, and a tightly knitted carpet frames the passage, tracing muted grey and gold stripes down its length.  The air feels unnaturally still here.

You can go north, south to the Hallway, east and west to the Empty Corridor from here.

>n
Something tells you  (put conditional here later)
Hallway
You are standing in the middle a long hallway that seems to stretch endlessly in either direction.  It is reminiscent of the halls that one might see in a fancy hotel; identical doors are spaced regularly along the walls on either side, each of which are outfitted with a black box above the handle designed to accept a key card. The walls are papered with a rich navy and powder-blue damask pattern, and a tightly knitted carpet frames the passage, tracing muted grey and gold stripes down its length.  The air feels unnaturally still here.

You can go north and south to the Hallway from here.

>w
Something tells you  (put conditional here later)
You can't go that way.

>n
Something tells you  (put conditional here later)
Hallway
You are standing in the middle a long hallway that seems to stretch endlessly in either direction.  It is reminiscent of the halls that one might see in a fancy hotel; identical doors are spaced regularly along the walls on either side, each of which are outfitted with a black box above the handle designed to accept a key card. The walls are papered with a rich navy and powder-blue damask pattern, and a tightly knitted carpet frames the passage, tracing muted grey and gold stripes down its length.  The air feels unnaturally still here.

You can go north, south to the Hallway, east and west from here.

>w
Something tells you  (put conditional here later)
Foyer
Despite being an isolated room in the middle of a hallway, this room appears to be a foyer. There is a small sofa and a shoe rack along the west wall. On the north wall, there is a clock. There is a staircase in the northwest corner leading down. The bottom of the stairs is in darkness, but you think you percieve the vague outline of a person there.

You can see a shoe rack (on which is a pair of women's heels) here.

You can go northwest and east to the Hallway from here.

* * *

>n
Hallway
You are standing in the middle a long hallway that seems to stretch endlessly in either direction.  It is reminiscent of the halls that one might see in a fancy hotel; identical doors are spaced regularly along the walls on either side, each of which are outfitted with a black box above the handle designed to accept a key card. The walls are papered with a rich navy and powder-blue damask pattern, and a tightly knitted carpet frames the passage, tracing muted grey and gold stripes down its length.  The air feels unnaturally still here.

You can go north, south to the Hallway, east and west from here.

>e
You shouldn't be here.
This is a square room with little ornamentation. You feel as if you shouldn't be here.

You can go west to the Hallway from here.

>examine door
You can't see any such thing.

* * *

>n
...you walk some distance down the length of the hallway until you arrive at the next set of adjacent doors...

Hallway
You are in the main hallway. It stretches indefinitely in either direction. There are doors to your east and west.

>e
Corridors
You are in a room like many others. The wallpaper is yellow here.

>e
You can't go that way.

>n
Corridors
You are in a room like many others. The wallpaper is yellow here.

>e
Yellow Room
The hallway diverges into many similar looking rooms with no furniture or ornamentation. You sense that if you keep going to the west, you may become lost. The wallpaper is yellow here.

>e
Hallway End
The hallway seems to end here. There are doors to the north, east, and west. There is something deeply disquieting about the doorway to the north, ordinary as it appears.

>what is the color
That's not a verb I recognise.

>examine color
You can't see any such thing.

* * *

>n
...you walk some distance down the length of the hallway until you arrive at the next set of adjacent doors...

Hallway
You are in the main hallway. It stretches indefinitely in either direction. There are doors to your east and west.

>w
Old Mall
The hallway opens up into what appears to be an empty shopping mall. There is a high domed cieling with skylights overhead. The floor transitions from the carpeted hallway to over-large tan octagonal tiles. They air is cool here and slightly more humid, as if there were a water source nearby. You think you may even hear the distant trickle of water. A few small trees can be seen in planters, spaced decoratively. In contrast to the tense and silent hallway, this space is pleasant and serene. You can see the entrance to several shops. The Ordinary Shop is to the northeast, the Extraordinary Shop is to the northwest, and The Lonely and Dark stores are to the east and west respectively. There is also an escalator leading up to a second floor.

You can go north, south, southwest, east to the Hallway, west and up from here.

>e
Old Mall
The hallway opens up into what appears to be an empty shopping mall. There is a high domed cieling with skylights overhead. The floor transitions from the carpeted hallway to over-large tan octagonal tiles. They air is cool here and slightly more humid, as if there were a water source nearby. You think you may even hear the distant trickle of water. A few small trees can be seen in planters, spaced decoratively. In contrast to the tense and silent hallway, this space is pleasant and serene. You can see the entrance to several shops. The Ordinary Shop is to the northeast, the Extraordinary Shop is to the northwest, and The Lonely and Dark stores are to the east and west respectively. There is also an escalator leading up to a second floor.

You can go north, south to the Lonely Room, southwest, east, west to the Extraordinary Room and up from here.

>e
Hallway
You are in a long hallway.  Identical doors are spaced regularly along the walls on either side.  Many of the doors are closed and locked, but there are two doors to your immediate left and right (east and west) that are slightly ajar, and you can see two similar doors further down the hallway. The wall paper is a rich navy and powder-blue damask pattern. Combined with the dark wooden wainscotting, it gives the hallway an unnderving air of false comfort, with vauge suggestions of austerity. 

You can go north, south and west to the Old Mall from here.

>n
Hallway
You are in a long hallway.  Identical doors are spaced regularly along the walls on either side. Many of the doors are closed and locked, but there are two doors to your immediate left and right (east and west) that are slightly ajar, and you can see two similar doors further down the hallway. There a door to the south, and something about it is deeply disquieting, ordinary as it looks. The wall paper is a rich navy and powder-blue damask pattern. Combined with the dark wooden wainscotting, it gives the hallways an unnderving air of false comfort, with vauge suggestions of austerity.The air feels unnaturally still here.

You can go north, south to the Hallway, east and west from here.

>n
Hallway
You are in a long hallway.  Identical doors are spaced regularly along the walls on either side. Many of the doors are closed and locked, but there are two doors to your immediate left and right (east and west) that are slightly ajar, and you can see two similar doors further down the hallway. There a door to the south, and something about it is deeply disquieting, ordinary as it looks. The wall paper is a rich navy and powder-blue damask pattern. Combined with the dark wooden wainscotting, it gives the hallways an unnderving air of false comfort, with vauge suggestions of austerity.The air feels unnaturally still here.

You can go north and south to the Hallway from here.

>n
Hallway
You are in a long hallway.  Identical doors are spaced regularly along the walls on either side. Many of the doors are closed and locked, but there are two doors to your immediate left and right (east and west) that are slightly ajar, and you can see two similar doors further down the hallway. The wall paper is a rich navy and powder-blue damask pattern. Combined with the dark wooden wainscotting, it gives the hallways an unnderving air of false comfort, with vauge suggestions of austerity.

You can go north, south to the Hallway, east and west from here.

>n
Hallway
You are in a long hallway.  Identical doors are spaced regularly along the walls on either side. Many of the doors are closed and locked, but there are two doors to your immediate left and right (east and west) that are slightly ajar, and you can see two similar doors further down the hallway. The wall paper is a rich navy and powder-blue damask pattern. Combined with the dark wooden wainscotting, it gives the hallways an unnderving air of false comfort, with vauge suggestions of austerity. Near the east door, there is a spot on the wall where the wallpaper is peeling. You see a torn piece.

A neat section of the blue damask wall paper has torn, revealing a patch of yellow beneath it. You admire the torn piece.

You can go north to the Hallway, south to the Hallway, east and west from here.

>n
Hallway
You are in a long hallway.  Identical doors are spaced regularly along the walls on either side.  Many of the doors are closed and locked, but there are two doors to your immediate left and right (east and west) that are slightly ajar, and you can see two similar doors further down the hallway. The wall paper is a rich navy and powder-blue damask pattern. Combined with the dark wooden wainscotting, it gives the hallway an unnderving air of false comfort, with vauge suggestions of austerity. 

You can go north to the Hallway, south to the Hallway and west to the Old Mall from here.

>n
Hallway
You are in a long hallway.  Identical doors are spaced regularly along the walls on either side. Many of the doors are closed and locked, but there are two doors to your immediate left and right (east and west) that are slightly ajar, and you can see two similar doors further down the hallway. There a door to the south, and something about it is deeply disquieting, ordinary as it looks. The wall paper is a rich navy and powder-blue damask pattern. Combined with the dark wooden wainscotting, it gives the hallways an unnderving air of false comfort, with vauge suggestions of austerity.The air feels unnaturally still here.

You can go north to the Hallway, south to the Hallway, east and west from here.

>n
Hallway
You are in a long hallway.  Identical doors are spaced regularly along the walls on either side. Many of the doors are closed and locked, but there are two doors to your immediate left and right (east and west) that are slightly ajar, and you can see two similar doors further down the hallway. There a door to the south, and something about it is deeply disquieting, ordinary as it looks. The wall paper is a rich navy and powder-blue damask pattern. Combined with the dark wooden wainscotting, it gives the hallways an unnderving air of false comfort, with vauge suggestions of austerity.The air feels unnaturally still here.

You can go north to the Hallway and south to the Hallway from here.

>n
Hallway
You are in a long hallway.  Identical doors are spaced regularly along the walls on either side. Many of the doors are closed and locked, but there are two doors to your immediate left and right (east and west) that are slightly ajar, and you can see two similar doors further down the hallway. The wall paper is a rich navy and powder-blue damask pattern. Combined with the dark wooden wainscotting, it gives the hallways an unnderving air of false comfort, with vauge suggestions of austerity.

You can go north to the Hallway, south to the Hallway, east and west from here.

>n
Hallway
You are in a long hallway.  Identical doors are spaced regularly along the walls on either side. Many of the doors are closed and locked, but there are two doors to your immediate left and right (east and west) that are slightly ajar, and you can see two similar doors further down the hallway. The wall paper is a rich navy and powder-blue damask pattern. Combined with the dark wooden wainscotting, it gives the hallways an unnderving air of false comfort, with vauge suggestions of austerity. Near the east door, there is a spot on the wall where the wallpaper is peeling. You see a torn piece.

A neat section of the blue damask wall paper has torn, revealing a patch of yellow beneath it. You admire the torn piece.

You can go north to the Hallway, south to the Hallway, east and west from here.

>w
Bedroom
This looks like a bedroom. There is a bed, a wardrobe, and a mirror. There is also a small night light plugged into an outlet in the wall.

 The night light is off.

You can also see a wardrobe (closed) and a cabinet (closed) here.

You can go east to the Hallway from here.

>e
Hallway
You are in a long hallway.  Identical doors are spaced regularly along the walls on either side. Many of the doors are closed and locked, but there are two doors to your immediate left and right (east and west) that are slightly ajar, and you can see two similar doors further down the hallway. The wall paper is a rich navy and powder-blue damask pattern. Combined with the dark wooden wainscotting, it gives the hallways an unnderving air of false comfort, with vauge suggestions of austerity. Near the east door, there is a spot on the wall where the wallpaper is peeling. You see a torn piece.

A neat section of the blue damask wall paper has torn, revealing a patch of yellow beneath it. You admire the torn piece.

You can go north to the Hallway, south to the Hallway, east and west to the Bedroom from here.

>n
Hallway
You are in a long hallway.  Identical doors are spaced regularly along the walls on either side.  Many of the doors are closed and locked, but there are two doors to your immediate left and right (east and west) that are slightly ajar, and you can see two similar doors further down the hallway. The wall paper is a rich navy and powder-blue damask pattern. Combined with the dark wooden wainscotting, it gives the hallway an unnderving air of false comfort, with vauge suggestions of austerity. 

You can go north to the Hallway, south to the Hallway and west to the Old Mall from here.

* * *

>s
Lonely Room
This is a small room.

You are the only thing here. 

You can go north to the Old Mall from here.

>n
Old Mall
The hallway opens up into what appears to be an empty shopping mall. There is a high domed cieling with skylights overhead. The floor transitions from the carpeted hallway to over-large tan octagonal tiles. They air is cool here and slightly more humid, as if there were a water source nearby. You think you may even hear the distant trickle of water. A few small trees can be seen in planters, spaced decoratively. In contrast to the tense and silent hallway, this space is pleasant and serene. You can see the entrance to several shops. The Ordinary Shop is to the northeast, the Extraordinary Shop is to the northwest, and The Lonely and Dark stores are to the east and west respectively. There is also an escalator leading up to a second floor.

You can go north, south to the Lonely Room, southwest, east to the Hallway, west and up from here.

>e
Hallway
You are standing in the middle a long hallway that seems to stretch endlessly in either direction.  It is reminiscent of the halls that one might see in a fancy hotel; identical doors are spaced regularly along the walls on either side, each of which are outfitted with a black box above the handle designed to accept a key card. The walls are papered with a rich navy and powder-blue damask pattern, and a tightly knitted carpet frames the passage, tracing muted grey and gold stripes down its length.  The air feels unnaturally still here.

You can go north, south to the Hallway and west to the Old Mall from here.

>w
Old Mall
The hallway opens up into what appears to be an empty shopping mall. There is a high domed cieling with skylights overhead. The floor transitions from the carpeted hallway to over-large tan octagonal tiles. They air is cool here and slightly more humid, as if there were a water source nearby. You think you may even hear the distant trickle of water. A few small trees can be seen in planters, spaced decoratively. In contrast to the tense and silent hallway, this space is pleasant and serene. You can see the entrance to several shops. The Ordinary Shop is to the northeast, the Extraordinary Shop is to the northwest, and The Lonely and Dark stores are to the east and west respectively. There is also an escalator leading up to a second floor.

You can go north, south to the Lonely Room, southwest, east to the Hallway, west and up from here.

>w
Extraordinary Room
This room is completely dark.

You can see something here.

You can go east to the Old Mall from here.

>e
Old Mall
The hallway opens up into what appears to be an empty shopping mall. There is a high domed cieling with skylights overhead. The floor transitions from the carpeted hallway to over-large tan octagonal tiles. They air is cool here and slightly more humid, as if there were a water source nearby. You think you may even hear the distant trickle of water. A few small trees can be seen in planters, spaced decoratively. In contrast to the tense and silent hallway, this space is pleasant and serene. You can see the entrance to several shops. The Ordinary Shop is to the northeast, the Extraordinary Shop is to the northwest, and The Lonely and Dark stores are to the east and west respectively. There is also an escalator leading up to a second floor.

You can go north, south to the Lonely Room, southwest, east to the Hallway, west to the Extraordinary Room and up from here.

>n
Ordinary Room
This room is completely dark.

You can see nothing here.

You can go south to the Old Mall from here.

>s
Old Mall
The hallway opens up into what appears to be an empty shopping mall. There is a high domed cieling with skylights overhead. The floor transitions from the carpeted hallway to over-large tan octagonal tiles. They air is cool here and slightly more humid, as if there were a water source nearby. You think you may even hear the distant trickle of water. A few small trees can be seen in planters, spaced decoratively. In contrast to the tense and silent hallway, this space is pleasant and serene. You can see the entrance to several shops. The Ordinary Shop is to the northeast, the Extraordinary Shop is to the northwest, and The Lonely and Dark stores are to the east and west respectively. There is also an escalator leading up to a second floor.

You can go north to the Ordinary Room, south to the Lonely Room, southwest, east to the Hallway, west to the Extraordinary Room and up from here.

>sw
Darkness
It is dark here.

You see nothing but the darkness.

You can go northeast to the Old Mall from here.

>open darkness
You open the darkness, revealing a black key.

>take key
As you take the key, you are breifly overcome by a wave of vertigo. A knot forms in your stomach, and you have the terrible feeling that you have taken something which does not belong to you.

>s
You can't go that way.

>e
You can't go that way.

>e
You can't go that way.

* * *

>w
You can't go that way.

>ne
Old Mall
The hallway opens up into what appears to be an empty shopping mall. There is a high domed cieling with skylights overhead. The floor transitions from the carpeted hallway to over-large tan octagonal tiles. They air is cool here and slightly more humid, as if there were a water source nearby. You think you may even hear the distant trickle of water. A few small trees can be seen in planters, spaced decoratively. In contrast to the tense and silent hallway, this space is pleasant and serene. You can see the entrance to several shops. The Ordinary Shop is to the northeast, the Extraordinary Shop is to the northwest, and The Lonely and Dark stores are to the east and west respectively. There is also an escalator leading up to a second floor.

You can go north to the Ordinary Room, south to the Lonely Room, southwest to the Darkness, east to the Hallway, west to the Extraordinary Room and up from here.

>e
Hallway
You are standing in the middle a long hallway that seems to stretch endlessly in either direction.  It is reminiscent of the halls that one might see in a fancy hotel; identical doors are spaced regularly along the walls on either side, each of which are outfitted with a black box above the handle designed to accept a key card. The walls are papered with a rich navy and powder-blue damask pattern, and a tightly knitted carpet frames the passage, tracing muted grey and gold stripes down its length.  The air feels unnaturally still here.

You can go north, south to the Hallway and west to the Old Mall from here.

>e
You can't go that way.

>n
Hallway
You are standing in the middle a long hallway that seems to stretch endlessly in either direction.  It is reminiscent of the halls that one might see in a fancy hotel; identical doors are spaced regularly along the walls on either side, each of which are outfitted with a black box above the handle designed to accept a key card. The walls are papered with a rich navy and powder-blue damask pattern, and a tightly knitted carpet frames the passage, tracing muted grey and gold stripes down its length.  The air feels unnaturally still here.

You can go north, south to the Hallway, east and west from here.

>e
Outside Room
Opening the door reveals what at first looks to be a wide outdoor space filled with shrubs and grasses. A fog hangs in the air above you, obscuring the view upward. The illusion is broken by many white pillars holding up what must be a distant cieling. In the east corner of this large room is a small plastic house.

You can go east and west to the Hallway from here.

>w
Hallway
You are standing in the middle a long hallway that seems to stretch endlessly in either direction.  It is reminiscent of the halls that one might see in a fancy hotel; identical doors are spaced regularly along the walls on either side, each of which are outfitted with a black box above the handle designed to accept a key card. The walls are papered with a rich navy and powder-blue damask pattern, and a tightly knitted carpet frames the passage, tracing muted grey and gold stripes down its length.  The air feels unnaturally still here.

You can go north, south to the Hallway, east to the Outside Room and west from here.

>w
Empty Corridor
This is a long section of empty hallway. Further west, you see that the hallway diverges into similar looking corridors with no doors, no furniture and no ornamentation. You sense that if you keep going to the west, you may become lost. The wallpaper is yellow here.

You can go east to the Hallway and west from here.

>e
Hallway
You are standing in the middle a long hallway that seems to stretch endlessly in either direction.  It is reminiscent of the halls that one might see in a fancy hotel; identical doors are spaced regularly along the walls on either side, each of which are outfitted with a black box above the handle designed to accept a key card. The walls are papered with a rich navy and powder-blue damask pattern, and a tightly knitted carpet frames the passage, tracing muted grey and gold stripes down its length.  The air feels unnaturally still here.

You can go north, south to the Hallway, east to the Outside Room and west to the Empty Corridor from here.

>n
Hallway
You are standing in the middle a long hallway that seems to stretch endlessly in either direction.  It is reminiscent of the halls that one might see in a fancy hotel; identical doors are spaced regularly along the walls on either side, each of which are outfitted with a black box above the handle designed to accept a key card. The walls are papered with a rich navy and powder-blue damask pattern, and a tightly knitted carpet frames the passage, tracing muted grey and gold stripes down its length.  The air feels unnaturally still here.

You can go north and south to the Hallway from here.

>e
You can't go that way.

* * *

>w
You can't go that way.

>n
Hallway
You are standing in the middle a long hallway that seems to stretch endlessly in either direction.  It is reminiscent of the halls that one might see in a fancy hotel; identical doors are spaced regularly along the walls on either side, each of which are outfitted with a black box above the handle designed to accept a key card. The walls are papered with a rich navy and powder-blue damask pattern, and a tightly knitted carpet frames the passage, tracing muted grey and gold stripes down its length.  The air feels unnaturally still here.

You can go north to the Hallway, south to the Hallway, east and west from here.

>e
Place Where you Shouldn't Be
This is a square room with little ornamentation. You feel as if you shouldn't be here.

You can see a black door here.

You can go north through the black door (closed) and west to the Hallway from here.

* * *

>n
...you walk some distance down the length of the hallway until you arrive at the next set of adjacent doors...

Hallway
You are in the main hallway. It stretches indefinitely in either direction. There are doors to your east and west.

>n
Hallway
You are standing in the middle a long hallway that seems to stretch endlessly in either direction.  It is reminiscent of the halls that one might see in a fancy hotel; identical doors are spaced regularly along the walls on either side, each of which are outfitted with a black box above the handle designed to accept a key card. The walls are papered with a rich navy and powder-blue damask pattern, and a tightly knitted carpet frames the passage, tracing muted grey and gold stripes down its length.  The air feels unnaturally still here.

A neat section of the blue damask wall paper has torn, revealing a patch of yellow beneath it. You admire the torn piece.

You can also see a steel knife here.

You can go north, south to the Hallway, east and west from here.

>w
Bedroom
This looks like a child's bedroom.

There is a framed text on the wall. It looks like a nursery rhyme.

Against the far wall is a small white nightstand with a single drawer.

On the nightstand is an ornamental box.

You can also see a wardrobe and a cabinet here.

You can go east to the Hallway from here.

>e
Hallway
You are standing in the middle a long hallway that seems to stretch endlessly in either direction.  It is reminiscent of the halls that one might see in a fancy hotel; identical doors are spaced regularly along the walls on either side, each of which are outfitted with a black box above the handle designed to accept a key card. The walls are papered with a rich navy and powder-blue damask pattern, and a tightly knitted carpet frames the passage, tracing muted grey and gold stripes down its length.  The air feels unnaturally still here.

A neat section of the blue damask wall paper has torn, revealing a patch of yellow beneath it. You admire the torn piece.

You can also see a steel knife here.

You can go north, south to the Hallway, east and west to the Bedroom from here.

>e
Drinking Room
This room is fully furnished including a white fainting couch, a grandfather clock, and a coffee table. All of the furniture is made of the same dark, rich wood that can be found throughout. On the wall there is a full-sized mirror and a large painting of a woman. In the northeast corner you can see a small metal gate stretched across a doorway. You think you can hear a faint ticking sound.

There is a fully stocked bar in the corner. It is has a beautiful curved countertop and many shelves of liquors which reach to the cieling behind it. Almost all of the bottles are brand new and sealed.

On the bar are a bottle of whiskey, a bottle of vodka, a bottle of gin and a lemon.

You can see a grandfather clock here.

You can also see a metal gate here.

You can go northeast through the metal gate (closed) and west to the Hallway from here.

>w
Hallway
You are standing in the middle a long hallway that seems to stretch endlessly in either direction.  It is reminiscent of the halls that one might see in a fancy hotel; identical doors are spaced regularly along the walls on either side, each of which are outfitted with a black box above the handle designed to accept a key card. The walls are papered with a rich navy and powder-blue damask pattern, and a tightly knitted carpet frames the passage, tracing muted grey and gold stripes down its length.  The air feels unnaturally still here.

A neat section of the blue damask wall paper has torn, revealing a patch of yellow beneath it. You admire the torn piece.

You can also see a steel knife here.

You can go north, south to the Hallway, east to the Drinking Room and west to the Bedroom from here.

>s
Hallway
You are standing in the middle a long hallway that seems to stretch endlessly in either direction.  It is reminiscent of the halls that one might see in a fancy hotel; identical doors are spaced regularly along the walls on either side, each of which are outfitted with a black box above the handle designed to accept a key card. The walls are papered with a rich navy and powder-blue damask pattern, and a tightly knitted carpet frames the passage, tracing muted grey and gold stripes down its length.  The air feels unnaturally still here.

You can go north to the Hallway, south to the Hallway, east and west from here.

>w
Foyer
Despite being an isolated room in the middle of a hallway, this room appears to be a foyer. There is a small sofa and a shoe rack along the west wall. On the north wall, there is a clock. There is a staircase in the northwest corner leading down. The bottom of the stairs is in darkness, but you think you percieve the vague outline of a person there.

You can see a shoe rack (on which is a pair of women's heels) here.

You can go northwest and east to the Hallway from here.

>e
Hallway
You are standing in the middle a long hallway that seems to stretch endlessly in either direction.  It is reminiscent of the halls that one might see in a fancy hotel; identical doors are spaced regularly along the walls on either side, each of which are outfitted with a black box above the handle designed to accept a key card. The walls are papered with a rich navy and powder-blue damask pattern, and a tightly knitted carpet frames the passage, tracing muted grey and gold stripes down its length.  The air feels unnaturally still here.

You can go north to the Hallway, south to the Hallway, east and west to the Foyer from here.

>e
You shouldn't be here
This is a square room with little ornamentation. You feel as if you shouldn't be here.

You can see a black door here.

You can go north through the black door (closed) and west to the Hallway from here.

* * *

>n
...you walk some distance down the length of the hallway until you arrive at the next set of adjacent doors...

Hallway
You are in the main hallway. It stretches indefinitely in either direction. There are doors to your east and west.

>look
Hallway
This is a long hallway that seems to stretch endlessly in either direction.  It is reminiscent of the halls that one might see in a fancy hotel; identical doors are spaced regularly along the walls on either side, each of which are outfitted with a black box above the handle designed to accept a key card. The walls are papered with a rich navy and powder-blue damask pattern, and a tightly knitted carpet frames the passage, tracing muted grey and gold stripes down its length.  The air feels unnaturally still here.

You can go north, south to the Hallway, east and west from here.

>n
...you walk some distance down the length of the hallway until you arrive at the next set of adjacent doors...

Hallway
You are in the main hallway. It stretches indefinitely in either direction. There are doors to your east and west.

>w
Bedroom
This looks like a child's bedroom.

There is a framed text on the wall. It looks like a nursery rhyme.

Against the far wall is a small white nightstand with a single drawer.

On the nightstand is an ornamental box.

You can also see a wardrobe and a cabinet here.

You can go east from here.

* * *

>examine wall paper
The wall paper is a rich navy and yellow damask pattern. Combined with the dark wooden wainscotting, it gives the hallways an unnderving air of false comfort, with vauge suggestions of austerity.

* * *

>r
That's not a verb I recognise.

>w
Narrow Corridor
You can go east to the Hallway and west from here.

>w
A draft of air blows past you and the corridor opens up into an impossibly large space. For a moment you feel dizzy as you are overcome by a sudden awareness of your relative smallness. You briefly gaze upward at the huge and distant cieling...

Library Entrance
You are standing in a massive cillindrical atrium which rises twelve stories from the ground level terminating in a wide, domed, blue glass cieling. The entire outer wall is lined with shelves of leather-bound books of irregular shape and color. Also spaced along the cylindrical wall are four equidistant spiral staircases that wind upwards clockwise all the way to the top floor, with landings at each level. Chic and varied pieces furniture are strategically placed throughout, creating many small comfortable pockets for reclusive reading, Everything, including the stairs, is made with lustrous pieces of rich, polished mahogany. In the center of the dome, some distance away and to the west, you can see a broad desk made out of the same wood as can be found throughout. It looks like it may be the library's front desk, though it is hard to tell since the building is completely empty. 

You can go east to the Narrow Corridor from here.

* * *

>w
You can't go that way.

>e
Hallway
You are standing in the middle a long hallway that seems to stretch endlessly in either direction.  It is reminiscent of the halls that one might see in a fancy hotel; identical doors are spaced regularly along the walls on either side, each of which are outfitted with a black box above the handle designed to accept a key card. The walls are papered with a rich navy and powder-blue damask pattern, and a tightly knitted carpet frames the passage, tracing muted grey and gold stripes down its length.  The air feels unnaturally still here.

You can go north, south, east and west from here.

>e
Room 132
This room is completely dark.

You can see something here.

>look
Emerald Room
The door opens to a room in darkness. You step into the darkness and sense that there is something nearby.

>take
What do you want to take?

>take all
You can't see any such thing.

* * *

>e
Room 132
This room is completely dark.

You can see something here.

>w
Yet More Hallway
You are in a long hallway.  Identical doors are spaced regularly along the walls on either side. Each door has a sign beside it bearing a room number. There are two doors to your immediate left and right (east and west). The walls are papered. You can see the end of the hallway to the north.

>n
Even More Hallway
You are in a long hallway.  Identical doors are spaced regularly along the walls on either side. Each door has a sign beside it bearing a room number. There are two doors to your immediate left and right (east and west). Near the east door, there is a spot on the wall where the wallpaper is peeling. You see a torn piece.

A neat section of the blue damask wall paper has torn, revealing a patch of yellow beneath it. You admire the torn piece briefly.

>w
Room 129
This looks like a bedroom. There is a bed, a closet, and a mirror.

You can see a closet (closed) here.

>e
Even More Hallway
You are in a long hallway.  Identical doors are spaced regularly along the walls on either side. Each door has a sign beside it bearing a room number. There are two doors to your immediate left and right (east and west). Near the east door, there is a spot on the wall where the wallpaper is peeling. You see a torn piece.

A neat section of the blue damask wall paper has torn, revealing a patch of yellow beneath it. You admire the torn piece briefly.

>e
Room 130
This room is fully furnished, with a blue fainting couch, a grandfather clock, and a coffee table. All of the furniture is made of the same dark, rich wood that can be found throughout. On the wall there is a full-sized mirror, and a large painting of a woman.

There is a grandfather clock here.

There is a fully stocked bar in the corner.

On the bar are a bottle of whiskey, a bottle of vodka, a bottle of gin and a lemon.

>w
Even More Hallway
You are in a long hallway.  Identical doors are spaced regularly along the walls on either side. Each door has a sign beside it bearing a room number. There are two doors to your immediate left and right (east and west). Near the east door, there is a spot on the wall where the wallpaper is peeling. You see a torn piece.

A neat section of the blue damask wall paper has torn, revealing a patch of yellow beneath it. You admire the torn piece briefly.

>n
Yet More Hallway
You are in a long hallway.  Identical doors are spaced regularly along the walls on either side. Each door has a sign beside it bearing a room number. There are two doors to your immediate left and right (east and west). The walls are papered. You can see the end of the hallway to the north.

>w
You can't go that way.

>e
You can't go that way.

>n
Hallway End
The hallway seems to end here. There are doors to the north, east, and west. There is something deeply disquieting about the doorway to the north, ordinary as it appears.

>w
Trap Room
As you enter this room, the door behind you closes and locks.

* * *

>w
Yet More Hallway
You are in a long hallway.  Identical doors are spaced regularly along the walls on either side. Each door has a sign beside it bearing a room number. There are two doors to your immediate left and right (east and west). The walls are papered. You can see the end of the hallway to the north.

>w
Room 131
This room is completely dark.

You sense that there is something here.

>e
Yet More Hallway
You are in a long hallway.  Identical doors are spaced regularly along the walls on either side. Each door has a sign beside it bearing a room number. There are two doors to your immediate left and right (east and west). The walls are papered. You can see the end of the hallway to the north.

>e
Room 132
This room is completely dark.

You sense that there is something here.

>e
You can't go that way.

>w
Yet More Hallway
You are in a long hallway.  Identical doors are spaced regularly along the walls on either side. Each door has a sign beside it bearing a room number. There are two doors to your immediate left and right (east and west). The walls are papered. You can see the end of the hallway to the north.

* * *

>w
Room 131
This room is completely dark.

You sense that there is something here.

>examine nothing
You sense that there is something here.

* * *

>e
Room 132
This room is completely dark.

You can see something here.

>e
You can't go that way.

>w'
That's not a verb I recognise.

>w
Hallway
You are in a long hallway.  Identical doors are spaced regularly along the walls on either side. Each door has a sign beside it bearing a room number. There are two doors to your immediate left and right (east and west). There a door to the south, and something about it is deeply disquieting, ordinary as it looks. The walls are papered. The air feels unnaturally still here.

>w
Room 125
You see nothing but the darkness.

* * *

>e
Room 132
This room is completely dark.

You can see something here.

>take something
I don't suppose something would care for that.

>w
Yet More Hallway
You are in a long hallway.  Identical doors are spaced regularly along the walls on either side. Each door has a sign beside it bearing a room number. There are two doors to your immediate left and right (east and west). The walls are papered. You can see the end of the hallway to the north.

>w
Room 131
This room is completely dark.

You can see nothing here.

>take nothing
I don't suppose nothing would care for that.

* * *

>w
A draft of air blows past you and the corridor opens up into an impossibly large space. For a moment you feel dizzy as you are overcome by a sudden awareness of your relative smallness. You briefly gaze upward at the huge and distant cieling...

Library Entrance
You are standing in a massive cillindrical atrium which rises twelve stories from ground level terminating in a wide, domed, blue glass cieling. The entire outer wall is lined with shelves of leather-bound books of irregular shape and color. Also spaced along the cylindrical wall are four equidistant spiral staircases that wind clockwise all the way to the top, with landings at each level. Chic and varied pieces furniture are strategically placed throughout, creating many small comfortable pockets for reclusive reading, Everything, including the stairs, is made with lustrous pieces of rich, polished mahogany. In the center of the dome, some distance away and to the west, you can see what looks to be the library's front desk, though it is hard to tell since the building is completely empty. 

You can go east to the Narrow Corridor and west from here.

>e
Yet More Hallway
You are in a long hallway.  Identical doors are spaced regularly along the walls on either side. Each door has a sign beside it bearing a room number. There are two doors to your immediate left and right (east and west). The walls are papered. You can see the end of the hallway to the north.

>s
Hallway End
The hallway seems to end here. There are doors to the north, east, and west. There is something deeply disquieting about the doorway to the north, ordinary as it appears.

* * *

>e
Yet More Hallway
You are in a long hallway.  Identical doors are spaced regularly along the walls on either side. Each door has a sign beside it bearing a room number. There are two doors to your immediate left and right (east and west). The walls are papered. You can see the end of the hallway to the north.

>e
Room 132
This room is completely dark.

You can see something here.

* * *

>take something
I don't suppose something would care for that.

>examine something
You see nothing special about something.

>w
Yet More Hallway
You are in a long hallway.  Identical doors are spaced regularly along the walls on either side. Each door has a sign beside it bearing a room number. There are two doors to your immediate left and right (east and west). The walls are papered. You can see the end of the hallway to the north.

* * *

>s
Even More Hallway
You are in a long hallway.  Identical doors are spaced regularly along the walls on either side. Each door has a sign beside it bearing a room number. There are two doors to your immediate left and right (east and west). Near the east door, there is a spot on the wall where the wallpaper is peeling. You see a torn piece.

A neat section of the blue damask wall paper has torn, revealing a patch of yellow beneath it. You admire the torn piece briefly.

>take piece
Taken.

>s
More Hallway
You are in a long hallway.  Identical doors are spaced regularly along the walls on either side. Each door has a sign beside it bearing a room number. There are two doors to your immediate left and right (east and west). The walls are papered.

>s
Hallway
You are in a long hallway.  Identical doors are spaced regularly along the walls on either side. Each door has a sign beside it bearing a room number. There are two doors to your immediate left and right (east and west). There a door to the south, and something about it is deeply disquieting, ordinary as it looks. The walls are papered. The air feels unnaturally still here.

>s
You can't go that way.

>n
More Hallway
You are in a long hallway.  Identical doors are spaced regularly along the walls on either side. Each door has a sign beside it bearing a room number. There are two doors to your immediate left and right (east and west). The walls are papered.

>n
Even More Hallway
You are in a long hallway.  Identical doors are spaced regularly along the walls on either side. Each door has a sign beside it bearing a room number. There are two doors to your immediate left and right (east and west). Near the east door, there is a spot on the wall where the wallpaper is peeling. You see a torn piece.

>n
Yet More Hallway
You are in a long hallway.  Identical doors are spaced regularly along the walls on either side. Each door has a sign beside it bearing a room number. There are two doors to your immediate left and right (east and west). The walls are papered. You can see the end of the hallway to the north.

>n
Hallway End
The hallway seems to end here. There are doors to the north, east, and west. There is something deeply disquieting about the doorway to the north, ordinary as it appears.

>n
w The Hallway

>s
Hallway End
The hallway seems to end here. There are doors to the north, east, and west. There is something deeply disquieting about the doorway to the north, ordinary as it appears.

>n
w The Hallway

>n
You can't go that way.

>s
Hallway End
The hallway seems to end here. There are doors to the north, east, and west. There is something deeply disquieting about the doorway to the north, ordinary as it appears.

* * *

>s
Yet More Hallway
You are in a long hallway.  Identical doors are spaced regularly along the walls on either side. Each door has a sign beside it bearing a room number. There are two doors to your immediate left and right (east and west). The walls are papered. You can see the end of the hallway to the north.

>s
Even More Hallway
You are in a long hallway.  Identical doors are spaced regularly along the walls on either side. Each door has a sign beside it bearing a room number. There are two doors to your immediate left and right (east and west). Near the east door, there is a spot on the wall where the wallpaper is peeling. You see a torn piece.

>s
More Hallway
You are in a long hallway.  Identical doors are spaced regularly along the walls on either side. Each door has a sign beside it bearing a room number. There are two doors to your immediate left and right (east and west). The walls are papered.

I beg your pardon?

* * *

>look
Something tells you  (put conditional here later)

>w
Something tells you  (put conditional here later)

* * *

>w
Front Desk
You can go north and east to the Library Entrance from here.

>n
Nook
A long stroll across the radius of the dome takes you to one of many small, cozy nooks. Here a sofa, a coffee table and a wing-backed chairs is sectioned off from the main space by a room-dividing bookshelf.

Near the center of the room there is a glass display case containing many curious items. A small notice is taped to the glass.

You can go south to the Front Desk from here.

>examine notice
It says: "Rare items from oft-imagined worlds."

>examine case
In the display case are a spellbook, a linking book, an encycolpedia frobozzica, a coin pouch and a strange orb.

There is a small notice taped to the glass on top of the display case.

>open case
It seems to be locked.

* * *

>n
You walk some distance down the length of the hallway until you arrive at the next set of adjacent doors

Hallway
You are in the main hallway. It stretches indefinitely in either direction. There are doors to your east and west.

>s
More Hallway
You are in a long hallway.  Identical doors are spaced regularly along the walls on either side. Each door has a sign beside it bearing a room number. There are two doors to your immediate left and right (east and west). The walls are papered.

* * *

>s
Hallway
You are in a long hallway.  Identical doors are spaced regularly along the walls on either side. Each door has a sign beside it bearing a room number. There are two doors to your immediate left and right (east and west). There a door to the south, and something about it is deeply disquieting, ordinary as it looks. The walls are papered. The air feels unnaturally still here.

>w
Room 125
You see nothing but the darkness.

>examine darkness
You look into the darkness. It feels as if it could open up.

>open darkness
You open the darkness, revealing a black key.

>examine darkness
The yawning darkness is open before you.

In the darkness is a black key.

* * *

>n
You walk some distance down the length of the hallway until you arrive at the next set of adjacent doors

Hallway
You are in the main hallway. It stretches indefinitely in either direction. There are doors to your east and west.

>w
Utility Closet
This is a cramped, narrow room full of dirty shelves and hardware. The main light source is a pair of florescent tubes which hum unpleasantly overhead. This is augmented by the sqeaking of your feet on the linoleum tiles below. There are many odds and ends on the shelves: scraps of unused wall paper, cans of paste, rollers, an empty bottle of bleach, picture-frames, and two broken clocks. None of these seem to  be useful to you. There is also a yellowed, paint-stained sink.

You can see a metal gate here.

You can go southwest through the metal gate (closed) and east to the Corner from here.

>open gate
It seems to be locked.

* * *

>n
You walk some distance down the length of the hallway until you arrive at the next set of adjacent doors

Hallway
You are in the main hallway. It stretches indefinitely in either direction. There are doors to your east and west.

>n
You walk some distance down the length of the hallway until you arrive at the next set of adjacent doors

Hallway
You are standing in the middle a long hallway that seems to stretch endlessly in either direction.  It is reminiscent of the halls that one might see in a fancy hotel; identical doors are spaced regularly along the walls on either side, each of which are outfitted with a black box above the handle designed to accept a key card. The walls are papered with a rich navy and powder-blue damask pattern, and a tightly knitted carpet frames the passage, tracing muted grey and gold stripes down its length.  The air feels unnaturally still here.

A steel knife is embedded in the wall nearby.

A neat section of the blue damask wall paper has torn, revealing a patch of yellow beneath it. You admire the torn piece.

You can go north, south, east and west from here.

>n
You walk some distance down the length of the hallway until you arrive at the next set of adjacent doors

Hallway
You are standing in the middle a long hallway that seems to stretch endlessly in either direction.  It is reminiscent of the halls that one might see in a fancy hotel; identical doors are spaced regularly along the walls on either side, each of which are outfitted with a black box above the handle designed to accept a key card. The walls are papered with a rich navy and powder-blue damask pattern, and a tightly knitted carpet frames the passage, tracing muted grey and gold stripes down its length.  The air feels unnaturally still here.

You can go north, south to the Hallway and west from here.

>n
You walk some distance down the length of the hallway until you arrive at the next set of adjacent doors

Hallway
You are standing in the middle a long hallway that seems to stretch endlessly in either direction.  It is reminiscent of the halls that one might see in a fancy hotel; identical doors are spaced regularly along the walls on either side, each of which are outfitted with a black box above the handle designed to accept a key card. The walls are papered with a rich navy and powder-blue damask pattern, and a tightly knitted carpet frames the passage, tracing muted grey and gold stripes down its length.  The air feels unnaturally still here.

You can go north to the Hallway, south to the Hallway, east and west from here.

>n
You walk some distance down the length of the hallway until you arrive at the next set of adjacent doors

Hallway
You are standing in the middle a long hallway that seems to stretch endlessly in either direction.  It is reminiscent of the halls that one might see in a fancy hotel; identical doors are spaced regularly along the walls on either side, each of which are outfitted with a black box above the handle designed to accept a key card. The walls are papered with a rich navy and powder-blue damask pattern, and a tightly knitted carpet frames the passage, tracing muted grey and gold stripes down its length.  The air feels unnaturally still here.

You can go north, south to the Hallway, east and west from here.

>n
You walk some distance down the length of the hallway until you arrive at the next set of adjacent doors

Hallway
This is a long hallway that seems to stretch endlessly in either direction.  It is reminiscent of the halls that one might see in a fancy hotel; identical doors are spaced regularly along the walls on either side, each of which are outfitted with a black box above the handle designed to accept a key card. The walls are papered with a rich navy and powder-blue damask pattern, and a tightly knitted carpet frames the passage, tracing muted grey and gold stripes down its length.  The air feels unnaturally still here.

You can go north to the Hallway, south to the Hallway, east and west from here.

>n
You walk some distance down the length of the hallway until you arrive at the next set of adjacent doors

Hallway
You are standing in the middle a long hallway that seems to stretch endlessly in either direction.  It is reminiscent of the halls that one might see in a fancy hotel; identical doors are spaced regularly along the walls on either side, each of which are outfitted with a black box above the handle designed to accept a key card. The walls are papered with a rich navy and powder-blue damask pattern, and a tightly knitted carpet frames the passage, tracing muted grey and gold stripes down its length.  The air feels unnaturally still here.

A steel knife is embedded in the wall nearby.

A neat section of the blue damask wall paper has torn, revealing a patch of yellow beneath it. You admire the torn piece.

You can go north to the Hallway, south to the Hallway, east and west from here.

>n
You walk some distance down the length of the hallway until you arrive at the next set of adjacent doors

Hallway
You are standing in the middle a long hallway that seems to stretch endlessly in either direction.  It is reminiscent of the halls that one might see in a fancy hotel; identical doors are spaced regularly along the walls on either side, each of which are outfitted with a black box above the handle designed to accept a key card. The walls are papered with a rich navy and powder-blue damask pattern, and a tightly knitted carpet frames the passage, tracing muted grey and gold stripes down its length.  The air feels unnaturally still here.

You can go north to the Hallway, south to the Hallway and west from here.

>n
You walk some distance down the length of the hallway until you arrive at the next set of adjacent doors

Hallway
You are standing in the middle a long hallway that seems to stretch endlessly in either direction.  It is reminiscent of the halls that one might see in a fancy hotel; identical doors are spaced regularly along the walls on either side, each of which are outfitted with a black box above the handle designed to accept a key card. The walls are papered with a rich navy and powder-blue damask pattern, and a tightly knitted carpet frames the passage, tracing muted grey and gold stripes down its length.  The air feels unnaturally still here.

You can go north to the Hallway, south to the Hallway, east and west from here.

>n
You walk some distance down the length of the hallway until you arrive at the next set of adjacent doors

Hallway
You are standing in the middle a long hallway that seems to stretch endlessly in either direction.  It is reminiscent of the halls that one might see in a fancy hotel; identical doors are spaced regularly along the walls on either side, each of which are outfitted with a black box above the handle designed to accept a key card. The walls are papered with a rich navy and powder-blue damask pattern, and a tightly knitted carpet frames the passage, tracing muted grey and gold stripes down its length.  The air feels unnaturally still here.

You can go north to the Hallway, south to the Hallway, east and west from here.

>n
You walk some distance down the length of the hallway until you arrive at the next set of adjacent doors

Hallway
This is a long hallway that seems to stretch endlessly in either direction.  It is reminiscent of the halls that one might see in a fancy hotel; identical doors are spaced regularly along the walls on either side, each of which are outfitted with a black box above the handle designed to accept a key card. The walls are papered with a rich navy and powder-blue damask pattern, and a tightly knitted carpet frames the passage, tracing muted grey and gold stripes down its length.  The air feels unnaturally still here.

You can go north to the Hallway, south to the Hallway, east and west from here.

* * *

>n
You walk some distance down the length of the hallway until you arrive at the next set of adjacent doors

Hallway
You are in the main hallway. It stretches indefinitely in either direction. There are doors to your east and west.

I beg your pardon?

>n
You walk some distance down the length of the hallway until you arrive at the next set of adjacent doors

Hallway
You are standing in the middle a long hallway that seems to stretch endlessly in either direction.  It is reminiscent of the halls that one might see in a fancy hotel; identical doors are spaced regularly along the walls on either side, each of which are outfitted with a black box above the handle designed to accept a key card. The walls are papered with a rich navy and powder-blue damask pattern, and a tightly knitted carpet frames the passage, tracing muted grey and gold stripes down its length.  The air feels unnaturally still here.

A steel knife is embedded in the wall nearby.

A neat section of the blue damask wall paper has torn, revealing a patch of yellow beneath it. You admire the torn piece.

You can go north, south to the Hallway, east and west from here.

* * *

>s
You walk some distance down the length of the hallway until you arrive at the next set of adjacent doors

Hallway
You are in the main hallway. It stretches indefinitely in either direction. There are doors to your east and west.

>w
Utility Closet
This is a cramped, narrow room full of dirty shelves and hardware. The main light source is a pair of florescent tubes which hum unpleasantly overhead. This is augmented by the sqeaking of your feet on the linoleum tiles below. There are many odds and ends on the shelves: scraps of unused wall paper, cans of paste, rollers, an empty bottle of bleach, picture-frames, and two broken clocks. None of these seem to  be useful to you. There is also a yellowed, paint-stained sink.

You can see a metal gate here.

>examine darkness
You look into the darkness. It feels as if it could open up.

* * *

>open darkness
You open the darkness, revealing a black key.

>examine darknes
You can't see any such thing.

>examine darkness
You feel the yawning darkness all around you.

In the darkness is a black key.

* * *

>w
Utility Closet
This is a cramped, narrow room full of dirty shelves and hardware. The main light source is a pair of florescent tubes which hum unpleasantly overhead. This is augmented by the sqeaking of your feet on the linoleum tiles below. There are many odds and ends on the shelves: scraps of unused wall paper, cans of paste, rollers, an empty bottle of bleach, picture-frames, and two broken clocks. None of these seem to  be useful to you. There is also a yellowed, paint-stained sink.

You can see a metal gate here.

>sw
(first opening the metal gate)
It seems to be locked.

>open gate with key
You unlock the metal gate.

>sw
(first opening the metal gate)

Drinking Room
This room is fully furnished, with a white fainting couch, a grandfather-clock, and a coffee table. All of the furniture is made of the same dark, rich wood that can be found throughout. On the wall there is a full-sized mirror and a large painting of a woman. In the northeast corner you can see a small metal gate stretched across a doorway. You think you can hear a faint ticking sound.

There is a grandfather-clock here.

There is a fully stocked bar in the corner. It is has a beautiful curved countertop, and many shelves of liqours reach to the cieling behind it. Almost all of the bottles are brand new and sealed.

On the bar are a bottle of whiskey, a bottle of vodka, a bottle of gin and a lemon.

You can also see a metal gate here.

>examine mirror
Closer inspection reveals that it is not a mirror, but a picture of a mirror. You cannot see your reflection.

>w
Even More Hallway
You are in a long hallway.  Identical doors are spaced regularly along the walls on either side.  There are two doors to your immediate left and right (east and west). Near the east door, there is a spot on the wall where the wallpaper is peeling. You see a torn piece.

A neat section of the blue damask wall paper has torn, revealing a patch of yellow beneath it. You admire the torn piece briefly.

>n
Yet More Hallway
You are in a long hallway.  Identical doors are spaced regularly along the walls on either side.  There are two doors to your immediate left and right (east and west). The walls are papered. You can see the end of the hallway to the north.

>w
Ordinary Room
This room is completely dark.

You can see nothing here.

>e
Yet More Hallway
You are in a long hallway.  Identical doors are spaced regularly along the walls on either side.  There are two doors to your immediate left and right (east and west). The walls are papered. You can see the end of the hallway to the north.

>e
Extraordinary Room
This room is completely dark.

You can see something here.

* * *

>s
You walk some distance down the length of the hallway until you arrive at the next set of adjacent doors

Hallway
You are in the main hallway. It stretches indefinitely in either direction. There are doors to your east and west.

>s
You walk some distance down the length of the hallway until you arrive at the next set of adjacent doors

Hallway
You are in the main hallway. It stretches indefinitely in either direction. There are doors to your east and west.

>n
You walk some distance down the length of the hallway until you arrive at the next set of adjacent doors

Hallway
You are in the main hallway. It stretches indefinitely in either direction. There are doors to your east and west.

>n
You walk some distance down the length of the hallway until you arrive at the next set of adjacent doors

Hallway
You are in the main hallway. It stretches indefinitely in either direction. There are doors to your east and west.

>look
Hallway
You are standing in the middle a long hallway that seems to stretch endlessly in either direction.  It is reminiscent of the halls that one might see in a fancy hotel; identical doors are spaced regularly along the walls on either side, each of which are outfitted with a black box above the handle designed to accept a key card. The walls are papered with a rich navy and powder-blue damask pattern, and a tightly knitted carpet frames the passage, tracing muted grey and gold stripes down its length.  The air feels unnaturally still here.

You can go north to the Hallway, south, east and west from here.

>n
You walk some distance down the length of the hallway until you arrive at the next set of adjacent doors

Hallway
You are in the main hallway. It stretches indefinitely in either direction. There are doors to your east and west.

* * *

>examine wall apper
I only understood you as far as wanting to examine the wall paper.

>examine wall paper
The wall paper is a rich navy and yellow damask pattern. Combined with the dark wooden wainscotting, it gives the hallways an unnderving air of false comfort, with vauge suggestions of austerity.

* * *

>sw
You can't go that way.

>se
Foyer
Despite being an isolated room in the middle of a hallway, this room appears to be a foyer. There is a small sofa and a shoe rack along the west wall. On the north wall, there is a clock. There is a staircase in the northwest corner leading down. The bottom of the stairs is in darkness, but you think you percieve the vague outline of a person there.

You can see a shoe rack (on which is a pair of women's heels) here.

You can go northwest to the Stair Landing and east from here.

>w
You can't go that way.

>e
Hallway
This is a long hallway that seems to stretch endlessly in either direction.  It is reminiscent of the halls that one might see in a fancy hotel; identical doors are spaced regularly along the walls on either side, each of which are outfitted with a black box above the handle designed to accept a key card. The walls are papered with a rich navy and powder-blue damask pattern, and a tightly knitted carpet frames the passage, tracing muted grey and gold stripes down its length.  The air feels unnaturally still here.

You can go north, south, east and west to the Foyer from here.

>w
Foyer
You can see a shoe rack (on which is a pair of women's heels) here.

You can go northwest to the Stair Landing and east to the Hallway from here.

>e
Hallway
You can go north, south, east and west to the Foyer from here.

>w
Foyer
You can see a shoe rack (on which is a pair of women's heels) here.

You can go northwest to the Stair Landing and east to the Hallway from here.

* * *

>e
Hallway
You can go north, south, east and west to the Foyer from here.

>n
You walk some distance down the length of the hallway until you arrive at the next set of adjacent doors

Hallway
You are standing in the middle a long hallway that seems to stretch endlessly in either direction.  It is reminiscent of the halls that one might see in a fancy hotel; identical doors are spaced regularly along the walls on either side, each of which are outfitted with a black box above the handle designed to accept a key card. The walls are papered with a rich navy and powder-blue damask pattern, and a tightly knitted carpet frames the passage, tracing muted grey and gold stripes down its length.  The air feels unnaturally still here.

A steel knife is embedded in the wall nearby.

A neat section of the blue damask wall paper has torn, revealing a patch of yellow beneath it. You admire the torn piece.

You can go north, south to the Hallway, east and west from here.

>n
You walk some distance down the length of the hallway until you arrive at the next set of adjacent doors

Hallway
You are standing in the middle a long hallway that seems to stretch endlessly in either direction.  It is reminiscent of the halls that one might see in a fancy hotel; identical doors are spaced regularly along the walls on either side, each of which are outfitted with a black box above the handle designed to accept a key card. The walls are papered with a rich navy and powder-blue damask pattern, and a tightly knitted carpet frames the passage, tracing muted grey and gold stripes down its length.  The air feels unnaturally still here.

You can go north, south to the Hallway and west from here.

>n
You walk some distance down the length of the hallway until you arrive at the next set of adjacent doors

Hallway
You are standing in the middle a long hallway that seems to stretch endlessly in either direction.  It is reminiscent of the halls that one might see in a fancy hotel; identical doors are spaced regularly along the walls on either side, each of which are outfitted with a black box above the handle designed to accept a key card. The walls are papered with a rich navy and powder-blue damask pattern, and a tightly knitted carpet frames the passage, tracing muted grey and gold stripes down its length.  The air feels unnaturally still here.

You can go north, south to the Hallway, east and west from here.

* * *

>n
You walk some distance down the length of the hallway until you arrive at the next set of adjacent doors

Hallway
You can go north to the Hallway, south to the Hallway, east and west to the Foyer from here.

>n
You walk some distance down the length of the hallway until you arrive at the next set of adjacent doors

Hallway
A steel knife is embedded in the wall nearby.

A neat section of the blue damask wall paper has torn, revealing a patch of yellow beneath it. You admire the torn piece.

You can go north to the Hallway, south to the Hallway, east and west from here.

>n
You walk some distance down the length of the hallway until you arrive at the next set of adjacent doors

Hallway
You can go north to the Hallway, south to the Hallway and west from here.

* * *

>w
You can't go that way.

>w
You try going west, but there isn't an exit there.

>e
Corner
You wade through the debris and shimmy yourself into the narrow east corner of the utility closet, where it is even dirtier. You notice that the floor is damp here and the linoleum warped. There must have been a disturbance recently, because a cracked can of paste has permanently glued a pile of shattered glass to the floor on the north side of the passage. Behind it is a dingy crawlspace door.

You can see some broken glass here.

You can go west to the Utility Closet. The path to the north is blocked by the broken glass.

>e
Darkness
It is pitch dark, and you can't see a thing.

>e
You can't go that way.

* * *

>e
Darkness
It is pitch dark, and you can't see a thing.

>w
Hallway
You are in a long hallway.  Identical doors are spaced regularly along the walls on either side. Each door has a sign beside it bearing a room number. There are two doors to your immediate left and right (east and west). The air feels unnaturally still here.

>take air
Taken.

* * *

>e
Corner
You wade through the debris and shimmy yourself into the narrow east corner of the utility closet, where it is even dirtier. You notice that the floor is damp here and the linoleum warped. There must have been a disturbance recently, because a cracked can of paste has permanently glued a pile of shattered glass to the floor on the north side of the passage. Behind it is a dingy crawlspace door.

You can see some broken glass here.

You can go west to the Utility Closet. The path to the north is blocked by the broken glass.

>w
Darkness
It is dark here.

You see nothing but the darkness.

You can go east to the Great Hall from here.

>e
Great Hall
You can go northeast, northwest, east to the Lonely Room and west to the Darkness from here.

>sw
You can't go that way.

* * *

>se
You can't go that way.

>nw
Extraordinary Room
This room is completely dark.

You can see something here.

You can go southeast to the Great Hall from here.

>se
Great Hall
You can go northeast, northwest to the Extraordinary Room, east to the Lonely Room and west to the Darkness from here.

>ne
Ordinary Room
This room is completely dark.

You can see nothing here.

You can go southwest to the Great Hall from here.

>sw
Great Hall
You can go northeast to the Ordinary Room, northwest to the Extraordinary Room, east to the Lonely Room and west to the Darkness from here.

* * *

>e
Corner
You wade through the debris and shimmy yourself into the narrow east corner of the utility closet, where it is even dirtier. You notice that the floor is damp here and the linoleum warped. There must have been a disturbance recently, because a cracked can of paste has permanently glued a pile of shattered glass to the floor on the north side of the passage. Behind it is a dingy crawlspace door.

You can see some broken glass here.

You can go west to the Utility Closet. The path to the north is blocked by the broken glass.

>n
the broken glass is too sharp for you to cross barefoot.

>put on heels
You put on the pair of women's heels.

* * *

>w
You try going west, but there isn't an exit there.

>take nothing
You can't see any such thing.

* * *

>w
You try going west, but there isn't an exit there.

>s
Indistinguishable Corridors
You are in an empty corridor like many others. The wallpaper is yellow here.

These hallways are identical. You panic. You have lost your sense of direction.

>e
Yet More Hallway
You are in a long hallway.  Identical doors are spaced regularly along the walls on either side.  There are two doors to your immediate left and right (east and west). The walls are papered. You can see the end of the hallway to the north.

>s
Even More Hallway
You are in a long hallway.  Identical doors are spaced regularly along the walls on either side.  There are two doors to your immediate left and right (east and west). Near the east door, there is a spot on the wall where the wallpaper is peeling. You see a torn piece.

A neat section of the blue damask wall paper has torn, revealing a patch of yellow beneath it. You admire the torn piece briefly.

>take piece
Taken.

>s
More Hallway
You are in a long hallway.  Identical doors are spaced regularly along the walls on either side.  There are two doors to your immediate left and right (east and west). The walls are papered.

* * *

>s
Hallway
You are in a long hallway.  Identical doors are spaced regularly along the walls on either side.  There are two doors to your immediate left and right (east and west). There a door to the south, and something about it is deeply disquieting, ordinary as it looks. The walls are papered. The air feels unnaturally still here.

>e
Lonely Room
This is a small room.

You are the only thing here.

>examine you
You are the only thing here.

>take you
I don't suppose you would care for that.

>talk to you
That's not a verb I recognise.

>say "hi"
(to you)
There is no reply.

* * *

>s
Indistinguishable Corridors
You are in an empty corridor like many others. The wallpaper is yellow here.

These hallways are identical. You panic. You have lost your sense of direction.

>s
In your panic, you run into the south wall. There isn't an exit there. Your panic increases, and so does that terrible feeling of tension in the back of your mind.

* * *

>w
You try going west, but there isn't an exit there.

>n
Nook
A long stroll across the radius of the dome takes you to one of many small, cozy nooks. Here a sofa, a coffee table and a wing-backed chair is sectioned off from the main space by a room-dividing bookshelf.

Near the center of the room there is a glass display case containing many curious items. A small notice is taped to the glass.

You can go south to the Front Desk from here.

>examine case
In the glass display case are a spellbook, a linking book, an encycolpedia frobozzica, a coin pouch and a strange orb.

There is a small notice taped to the glass on top of the display case.

>take orb
The glass display case isn't open.

>open case
It seems to be locked.

* * *

>w
You try going west, but there isn't an exit there.

>w
You try going west, but there isn't an exit there. You are beginning to feel lost.

>w
You try going west, but there isn't an exit there. You are beginning to panic.

>w
You try going west, but there isn't an exit there. Your panic is increasing.

>w
You try going west, but there isn't an exit there.

>w
You try going west, but there isn't an exit there. Your panic is increasing.

>w
You try going west, but there isn't an exit there. Your panic is increasing.

>w
You try going west, but there isn't an exit there. You are beginning to panic.

>w
You try going west, but there isn't an exit there. You are beginning to panic.

* * *

>w
You try going west, but there isn't an exit there. Your panic is increasing.

>e
empty corridor
This is a long section of empty hallway. Further west, you see that the hallway diverges into similar looking corridors with no doors, no furniture and no ornamentation. You sense that if you keep going to the west, you may become lost. The wallpaper is yellow here.

You can go east and west to Indistinguishable Corridors from here.

>w
Indistinguishable Corridors
You are in an empty corridor like many others. The wallpaper is yellow here.

These hallways are identical. There are exits here, but you have lost your sense of direction.

>e
empty corridor
This is a long section of empty hallway. Further west, you see that the hallway diverges into similar looking corridors with no doors, no furniture and no ornamentation. You sense that if you keep going to the west, you may become lost. The wallpaper is yellow here.

You can go east and west to Indistinguishable Corridors from here.

* * *

>w
Indistinguishable Corridors
You are in an empty corridor like many others. The wallpaper is yellow here.

These hallways are identical. There are exits here, but you have lost your sense of direction.

>w
You try going west, but there isn't an exit there. Your panic is increasing.

* * *

>w
You try going west, but there isn't an exit there.

>ACTIONS
Actions listing on.

>W
[going west]
You try going west, but there isn't an exit there.
[going west - failed]

* * *

>w
You try going west, but there isn't an exit there.

>e
Empty Corridor
This is a long section of empty hallway. Further west, you see that the hallway diverges into similar looking corridors with no doors, no furniture and no ornamentation. You sense that if you keep going to the west, you may become lost. The wallpaper is yellow here.

You can go east and west to Indistinguishable Corridors from here.

>e
Hallway
You are standing in the middle a long hallway that seems to stretch endlessly in either direction.  It is reminiscent of the halls that one might see in a fancy hotel; identical doors are spaced regularly along the walls on either side, each of which are outfitted with a black box above the handle designed to accept a key card. The walls are papered with a rich navy and powder-blue damask pattern, and a tightly knitted carpet frames the passage, tracing muted grey and gold stripes down its length.  The air feels unnaturally still here.

You can go north, south, east and west to the Empty Corridor from here.

>w
Empty Corridor
This is a long section of empty hallway. Further west, you see that the hallway diverges into similar looking corridors with no doors, no furniture and no ornamentation. You sense that if you keep going to the west, you may become lost. The wallpaper is yellow here.

You can go east to the Hallway and west to Indistinguishable Corridors from here.

>w
Indistinguishable Corridors
You are in an empty corridor like many others. The wallpaper is yellow here.

These hallways are identical. There are exits here, but you have lost your sense of direction.

* * *

>e
Outside Room
Opening the door reveals what at first looks to be a wide outdoor space filled with shrubs and grasses. A fog hangs in the air above you, obscuring the view upward. The illusion is broken by many white pillars holding up what must be a distant cieling. In the east corner of this large room is a small plastic house.

You can go east and west to the Hallway from here.

>w
Hallway
You are standing in the middle a long hallway that seems to stretch endlessly in either direction.  It is reminiscent of the halls that one might see in a fancy hotel; identical doors are spaced regularly along the walls on either side, each of which are outfitted with a black box above the handle designed to accept a key card. The walls are papered with a rich navy and powder-blue damask pattern, and a tightly knitted carpet frames the passage, tracing muted grey and gold stripes down its length.  The air feels unnaturally still here.

You can go north, south, east to the Outside Room and west to the Empty Corridor from here.

>w
Empty Corridor
This is a long section of empty hallway. Further west, you see that the hallway diverges into similar looking corridors with no doors, no furniture and no ornamentation. You sense that if you keep going to the west, you may become lost. The wallpaper is yellow here.

You can go east to the Hallway and west to Indistinguishable Corridors from here.

* * *

>w
Indistinguishable Corridors
You are in an empty corridor like many others. The wallpaper is yellow here.

These hallways are identical. There are exits here, but you have lost your sense of direction.

>w
You run headfirst into the west wall. There isn't an exit there. You can feel the tension in the back of your mind increasing.

>w
You run headfirst into the west wall. There isn't an exit there. You can feel the tension in the back of your mind increasing.

* * *

>w
You can't go that way.

>take darkness
Taken.

>i
You are carrying:
  a darkness

* * *

>w
You can't go that way.

>examine darkness
You see nothing special about the darkness.

>take darkness
Taken.

* * *

>w
You can't go that way.

>n
Old Mall
The hallway opens up into what appears to be an empty shopping mall. There is a high domed cieling with skylights overhead. The floor transitions from the carpeted hallway to over-large tan octagonal tiles. They air is cool here and slightly more humid, as if there were a water source nearby. You think you may even hear the distant trickle of water. A few small trees can be seen in planters, spaced decoratively. In contrast to the tense and silent hallway, this space is pleasant and serene. You can see the entrance to several shops. The Ordinary Shop is to the northeast, the Extraordinary Shop is to the northwest, and The Lonely and Dark stores are to the east and west respectively. There is also an escalator leading up to a second floor.

You can go north, south to the Lonely Room, southwest, east, west and up from here.

>n
Hallway End
The hallway seems to end here. There are doors to the north, east, and west. There is something deeply unnerving about the doorway to the north, ordinary as it appears.

>w
Trap Room
As you enter this room, the door behind you closes and locks.

* * *

>w
Extraordinary Room
This room is completely dark.

You can see something here.

You can go east to the Old Mall from here.

>e
Old Mall
The hallway opens up into what appears to be an empty shopping mall. There is a high domed cieling with skylights overhead. The floor transitions from the carpeted hallway to over-large tan octagonal tiles. They air is cool here and slightly more humid, as if there were a water source nearby. You think you may even hear the distant trickle of water. A few small trees can be seen in planters, spaced decoratively. In contrast to the tense and silent hallway, this space is pleasant and serene. You can see the entrance to several shops. The Ordinary Shop is to the northeast, the Extraordinary Shop is to the northwest, and The Lonely and Dark stores are to the east and west respectively. There is also an escalator leading up to a second floor.

You can go north, south to the Lonely Room, southwest, east, west to the Extraordinary Room and up from here.

>e
Hallway
You are standing in the middle a long hallway that seems to stretch endlessly in either direction.  It is reminiscent of the halls that one might see in a fancy hotel; identical doors are spaced regularly along the walls on either side, each of which are outfitted with a black box above the handle designed to accept a key card. The walls are papered with a rich navy and powder-blue damask pattern, and a tightly knitted carpet frames the passage, tracing muted grey and gold stripes down its length.  The air feels unnaturally still here.

You can go north, south and west to the Old Mall from here.

I beg your pardon?

* * *

>w
You can't go that way.

>take you
You can't see any such thing.

>e
Room 126
This is a small room.

You are the only thing here.

>take you
I don't suppose you would care for that.

>examine you
You are the only thing here.

* * *

>w
You can't go that way.

>s
You can't go that way.

>e
test.

>examine mirror
Closer inspection reveals that it is not a mirror, but a picture of a mirror. You cannot see your reflection.

* * *

>e
test.

>look
Hallway
You are standing in the middle a long hallway that seems to stretch endlessly in either direction.  It is reminiscent of the halls that one might see in a fancy hotel; identical doors are spaced regularly along the walls on either side, each of which are outfitted with a black box above the handle designed to accept a key card. The walls are papered with a rich navy and powder-blue damask pattern, and a tightly knitted carpet frames the passage, tracing muted grey and gold stripes down its length.  The air feels unnaturally still here.

You can go north, south, east and west to the Narrow Corridor from here.

* * *

>s
You can't go that way.

>n
Corridors
You are in a room like many others. The wallpaper is yellow here.

>s
Corridors
You are in a room like many others. The wallpaper is yellow here.

>w
You can't go that way.

* * *

>n
Corridors
You are in a room like many others. The wallpaper is yellow here.

>w
You can't go that way.

>e
Corridors
The hallway diverges into many similar looking rooms with no furniture or ornamentation. You sense that if you keep going to the west, you may become lost. The wallpaper is yellow here.

* * *

>w
You can't go that way.

>sw
(first opening the metal gate)
It seems to be locked.

* * *

>open gate with key
You unlock the metal gate.

>sw
(first opening the metal gate)

Drinking Room
This room is fully furnished, with a white fainting couch, a grandfather-clock, and a coffee table. All of the furniture is made of the same dark, rich wood that can be found throughout. On the wall there is a full-sized mirror and a large painting of a woman. In the northeast corner you can see a small metal gate stretched across a doorway. You think you can hear a faint ticking sound.

There is a grandfather-clock here.

There is a fully stocked bar in the corner. It is has a beautiful curved countertop, and many shelves of liqours reach to the cieling behind it. Almost all of the bottles are brand new and sealed.

On the bar are a bottle of whiskey, a bottle of vodka, a bottle of gin and a lemon.

You can also see a metal gate here.

You can go northeast through the metal gate to the Utility Closet and west from here.

>w
Even More Hallway
You are in a long hallway.  Identical doors are spaced regularly along the walls on either side. Many of the doors are closed and locked, but there are two doors to your immediate left and right (east and west) that are slightly ajar, and you can see two similar doors further down the hallway. The wall paper is a rich navy and powder-blue damask pattern. Combined with the dark wooden wainscotting, it gives the hallways an unnderving air of false comfort, with vauge suggestions of austerity. Near the east door, there is a spot on the wall where the wallpaper is peeling. You see a torn piece.

A neat section of the blue damask wall paper has torn, revealing a patch of yellow beneath it. You admire the torn piece.

You can go north, south, east to the Drinking Room and west from here.

>w
Bedroom
This looks like a bedroom. There is a bed, a wardrobe, and a mirror. There is also a small night light plugged into an outlet in the wall.

 The night light is off.

You can also see a wardrobe (closed) here.

You can go east to the Even More Hallway from here.

>e
Even More Hallway
You are in a long hallway.  Identical doors are spaced regularly along the walls on either side. Many of the doors are closed and locked, but there are two doors to your immediate left and right (east and west) that are slightly ajar, and you can see two similar doors further down the hallway. The wall paper is a rich navy and powder-blue damask pattern. Combined with the dark wooden wainscotting, it gives the hallways an unnderving air of false comfort, with vauge suggestions of austerity. Near the east door, there is a spot on the wall where the wallpaper is peeling. You see a torn piece.

A neat section of the blue damask wall paper has torn, revealing a patch of yellow beneath it. You admire the torn piece.

You can go north, south, east to the Drinking Room and west to the Bedroom from here.

>n
Yet More Hallway
You are in a long hallway.  Identical doors are spaced regularly along the walls on either side.  Many of the doors are closed and locked, but there are two doors to your immediate left and right (east and west) that are slightly ajar, and you can see two similar doors further down the hallway. The wall paper is a rich navy and powder-blue damask pattern. Combined with the dark wooden wainscotting, it gives the hallway an unnderving air of false comfort, with vauge suggestions of austerity. You can see the end of the hallway to the north. 

You can go north, south to the Even More Hallway and west from here.

>w
Old Mall
The hallway opens up into what appears to be an empty shopping mall. There is a high domed cieling with skylights overhead. The floor transitions from the carpeted hallway to over-large tan octagonal tiles. They air is cool here and slightly more humid, as if there were a water source nearby. You think you may even hear the distant trickle of water. A few small trees can be seen in planters, spaced decoratively. In contrast to the tense and silent hallway, This space is pleasant and serene. You can see the entrance to several shops. The Ordinary Shop is to the northeast, the Extraordinary Shop is to the northwest, and The Lonely and Dark stores are to the east and west respectively. There is also an escalator leading up to a second floor.

You can go north, south, southwest, east to the Yet More Hallway, west and up from here.

>e
Yet More Hallway
You are in a long hallway.  Identical doors are spaced regularly along the walls on either side.  Many of the doors are closed and locked, but there are two doors to your immediate left and right (east and west) that are slightly ajar, and you can see two similar doors further down the hallway. The wall paper is a rich navy and powder-blue damask pattern. Combined with the dark wooden wainscotting, it gives the hallway an unnderving air of false comfort, with vauge suggestions of austerity. You can see the end of the hallway to the north. 

You can go north, south to the Even More Hallway and west to the Old Mall from here.

>n
Hallway End
The hallway seems to end here. There are doors to the north, east, and west. There is something deeply disquieting about the doorway to the north, ordinary as it appears.

You can go north, south to the Yet More Hallway, east and west from here.

>s
Yet More Hallway
You are in a long hallway.  Identical doors are spaced regularly along the walls on either side.  Many of the doors are closed and locked, but there are two doors to your immediate left and right (east and west) that are slightly ajar, and you can see two similar doors further down the hallway. The wall paper is a rich navy and powder-blue damask pattern. Combined with the dark wooden wainscotting, it gives the hallway an unnderving air of false comfort, with vauge suggestions of austerity. You can see the end of the hallway to the north. 

You can go north to the Hallway End, south to the Even More Hallway and west to the Old Mall from here.

>e
You can't go that way.

>n
Hallway End
The hallway seems to end here. There are doors to the north, east, and west. There is something deeply disquieting about the doorway to the north, ordinary as it appears.

You can go north, south to the Yet More Hallway, east and west from here.

>w
Empty Corridor
This is a long section of empty hallway. Further west, you see that the hallway diverges into similar looking corridors with no doors, no furniture and no ornamentation. You sense that if you keep going to the west, you may become lost. The wallpaper is yellow here.

You can go east to the Hallway End and west from here.

>e
Hallway End
The hallway seems to end here. There are doors to the north, east, and west. There is something deeply disquieting about the doorway to the north, ordinary as it appears.

You can go north, south to the Yet More Hallway, east and west to the Empty Corridor from here.

>e
Outside Room
Opening the door reveals what at first looks to be a wide outdoor space filled with shrubs and grasses. A fog hangs in the air above you, obscuring the view upward. The illusion is broken by many white pillars holding up what must be a distant cieling. In the east corner of this large room is a small plastic house.

You can go east and west to the Hallway End from here.

>w
Hallway End
The hallway seems to end here. There are doors to the north, east, and west. There is something deeply disquieting about the doorway to the north, ordinary as it appears.

You can go north, south to the Yet More Hallway, east to the Outside Room and west to the Empty Corridor from here.

>n
Hallway
You are in a long hallway.  Identical doors are spaced regularly along the walls on either side. Many of the doors are closed and locked, but there are two doors to your immediate left and right (east and west) that are slightly ajar, and you can see two similar doors further down the hallway. There a door to the south, and something about it is deeply disquieting, ordinary as it looks. The wall paper is a rich navy and powder-blue damask pattern. Combined with the dark wooden wainscotting, it gives the hallways an unnderving air of false comfort, with vauge suggestions of austerity.The air feels unnaturally still here.

You can go north and south to the Hallway End from here.

>w
You can't go that way.

* * *

>e
You can't go that way.

>n
More Hallway
You are in a long hallway.  Identical doors are spaced regularly along the walls on either side. Many of the doors are closed and locked, but there are two doors to your immediate left and right (east and west) that are slightly ajar, and you can see two similar doors further down the hallway. The wall paper is a rich navy and powder-blue damask pattern. Combined with the dark wooden wainscotting, it gives the hallways an unnderving air of false comfort, with vauge suggestions of austerity.

You can go north to the Even More Hallway, south to the Hallway, east and west from here.

>w
Foyer
Despite being an isolated room in the middle of a hallway, this room appears to be a foyer. There is a small sofa and a shoe rack along the west wall. On the north wall, there is a clock. There is a staircase in the northwest corner leading down. The bottom of the stairs is in darkness, but you think you percieve the vague outline of a person there.

You can see a shoe rack (on which is a pair of women's heels) here.

You can go northwest and east to the More Hallway from here.

>take heels
Taken.

>w
You can't go that way.

>e
More Hallway
You are in a long hallway.  Identical doors are spaced regularly along the walls on either side. Many of the doors are closed and locked, but there are two doors to your immediate left and right (east and west) that are slightly ajar, and you can see two similar doors further down the hallway. The wall paper is a rich navy and powder-blue damask pattern. Combined with the dark wooden wainscotting, it gives the hallways an unnderving air of false comfort, with vauge suggestions of austerity.

You can go north to the Even More Hallway, south to the Hallway, east and west to the Foyer from here.

>n
Even More Hallway
You are in a long hallway.  Identical doors are spaced regularly along the walls on either side. Many of the doors are closed and locked, but there are two doors to your immediate left and right (east and west) that are slightly ajar, and you can see two similar doors further down the hallway. The wall paper is a rich navy and powder-blue damask pattern. Combined with the dark wooden wainscotting, it gives the hallways an unnderving air of false comfort, with vauge suggestions of austerity. Near the east door, there is a spot on the wall where the wallpaper is peeling. You see a torn piece.

A neat section of the blue damask wall paper has torn, revealing a patch of yellow beneath it. You admire the torn piece.

You can go north to the Yet More Hallway, south to the More Hallway, east to the Drinking Room and west to the Bedroom from here.

>e
Drinking Room
This room is fully furnished, with a white fainting couch, a grandfather-clock, and a coffee table. All of the furniture is made of the same dark, rich wood that can be found throughout. On the wall there is a full-sized mirror and a large painting of a woman. In the northeast corner you can see a small metal gate stretched across a doorway. You think you can hear a faint ticking sound.

There is a grandfather-clock here.

There is a fully stocked bar in the corner. It is has a beautiful curved countertop, and many shelves of liqours reach to the cieling behind it. Almost all of the bottles are brand new and sealed.

On the bar are a bottle of whiskey, a bottle of vodka, a bottle of gin and a lemon.

You can also see a metal gate here.

You can go northeast through the metal gate to the Utility Closet and west to the Even More Hallway from here.

>ne
Utility Closet
This is a cramped, narrow room full of dirty shelves and hardware. The main light source is a pair of florescent tubes which hum unpleasantly overhead. This is augmented by the sqeaking of your feet on the linoleum tiles below. There are many odds and ends on the shelves: scraps of unused wall paper, cans of paste, rollers, an empty bottle of bleach, picture-frames, and two broken clocks. None of these seem to  be useful to you. There is also a yellowed, paint-stained sink.

You can see a metal gate here.

You can go southwest through the metal gate to the Drinking Room and east to the Corner from here.

>e
Corner
You wade through the debris and shimmy yourself into the narrow east corner of the utility closet, where it is even dirtier. You notice that the floor is damp here and the linoleum warped. There must have been a disturbance recently, because a cracked can of paste has permanently glued a pile of shattered glass to the floor on the north side of the passage. Behind it is a dingy crawlspace door.

You can see some broken glass here.

You can go west to the Utility Closet. The path to the north is blocked by the broken glass.

* * *

>put on heels
You put on the pair of women's heels.

>n
The high-heels protect your feet as you gingerly step over the broken glass.

Utility Closet
This is a cramped, narrow room full of dirty shelves and hardware. The main light source is a pair of florescent tubes which hum unpleasantly overhead. This is augmented by the sqeaking of your feet on the linoleum tiles below. There are many odds and ends on the shelves: scraps of unused wall paper, cans of paste, rollers, an empty bottle of bleach, picture-frames, and two broken clocks. None of these seem to  be useful to you. There is also a yellowed, paint-stained sink.

You can see a metal gate here.

You can go southwest through the metal gate to the Drinking Room and east to the Corner from here.

>e
Corner
You wade through the debris and shimmy yourself into the narrow east corner of the utility closet, where it is even dirtier. You notice that the floor is damp here and the linoleum warped. There must have been a disturbance recently, because a cracked can of paste has permanently glued a pile of shattered glass to the floor on the north side of the passage. Behind it is a dingy crawlspace door.

You can see some broken glass here.

You can go west to the Utility Closet. The path to the north is blocked by the broken glass.

>n
The high-heels protect your feet as you gingerly step over the broken glass.

Utility Closet
This is a cramped, narrow room full of dirty shelves and hardware. The main light source is a pair of florescent tubes which hum unpleasantly overhead. This is augmented by the sqeaking of your feet on the linoleum tiles below. There are many odds and ends on the shelves: scraps of unused wall paper, cans of paste, rollers, an empty bottle of bleach, picture-frames, and two broken clocks. None of these seem to  be useful to you. There is also a yellowed, paint-stained sink.

You can see a metal gate here.

You can go southwest through the metal gate to the Drinking Room and east to the Corner from here.

>w
You can't go that way.

>e
Corner
You wade through the debris and shimmy yourself into the narrow east corner of the utility closet, where it is even dirtier. You notice that the floor is damp here and the linoleum warped. There must have been a disturbance recently, because a cracked can of paste has permanently glued a pile of shattered glass to the floor on the north side of the passage. Behind it is a dingy crawlspace door.

You can see some broken glass here.

You can go west to the Utility Closet. The path to the north is blocked by the broken glass.

* * *

>w
You can't go that way.

>enter
You must supply a noun.

>enter house
You can't see any such thing.

>w
Empty Corridor
This is a long section of empty hallway. Further west, you see that the hallway diverges into similar looking corridors with no doors, no furniture and no ornamentation. You sense that if you keep going to the west, you may become lost. The wallpaper is yellow here.

You can go east to the Hallway End and west from here.

>e
Hallway End
The hallway seems to end here. There are doors to the north, east, and west. There is something deeply disquieting about the doorway to the north, ordinary as it appears.

You can go north, south, east to the Outside Room and west to the Empty Corridor from here.

>e
Outside Room
Opening the door reveals what at first looks to be a wide outdoor space filled with shrubs and grasses. A fog hangs in the air above you, obscuring the view upward. The illusion is broken by many white pillars holding up what must be a distant cieling. In the east corner of this large room is a small plastic house.

You can go east and west to the Hallway End from here.

>enter house
Play House
This house would be very cozy if it weren't sized for children. There is a kitchenette complete with a table, plastic stove and refrigerator, and a living room which contains a chair, a small throw rug, and a well-drawn picture of a television. There are many clocks drawn on the walls in crayon, each telling different times.

A little plastic stove that opens and closes.

A plastic refrigerator that opens and closes.

You can also see a table (on which is a plastic toaster) here.

You can go west to the Outside Room from here.

* * *

>w
You can't go that way.

>open door with library card
You unlock the unusual door.

>w
A draft of air blows past you and the corridor opens up into an impossibly large space. For a moment you feel dizzy as you are overcome by a sudden awareness of your relative smallness. You briefly gaze upward at the huge and distant cieling...

(first opening the unusual door)

Library Entrance
You are standing in a massive cillindrical atrium which rises twelve stories from ground level terminating in a wide, domed, blue glass cieling. The entire outer wall is lined with shelves of leather-bound books of irregular shape and color. Also spaced along the cylindrical wall are four equidistant spiral staircases that wind clockwise all the way to the top, with landings at each level. Chic and varied pieces furniture are strategically placed throughout, creating many small comfortable pockets for reclusive reading, Everything, including the stairs, is made with lustrous pieces of rich, polished mahogany. In the center of the dome, some distance away and to the west, you can see what looks to be the library's front desk, though it is hard to tell since the building is completely empty. 

You can see an unusual door here.

You can go east through the unusual door to the Narrow Corridor and west from here.

* * *

>w
You can't go that way.

>open door with card
You unlock the unusual door.

>w
(first opening the unusual door)

Library Entrance
You are standing in a massive cillindrical atrium which rises twelve stories from ground level terminating in a wide, domed, blue glass cieling. The entire outer wall is lined with shelves of leather-bound books of irregular shape and color. Also spaced along the cylindrical wall are four equidistant spiral staircases that wind clockwise all the way to the top, with landings at each level. Chic and varied pieces furniture are strategically placed throughout, creating many small comfortable pockets for reclusive reading, Everything, including the stairs, is made with lustrous pieces of rich, polished mahogany. In the center of the dome, some distance away and to the west, you can see what looks to be the library's front desk, though it is hard to tell since the building is completely empty. 

You can see an unusual door here.

You can go east through the unusual door to the Narrow Corridor and west from here.

>look
Library Entrance
You are standing in a massive cillindrical atrium which rises twelve stories from ground level terminating in a wide, domed, blue glass cieling. The entire outer wall is lined with shelves of leather-bound books of irregular shape and color. Also spaced along the cylindrical wall are four equidistant spiral staircases that wind clockwise all the way to the top, with landings at each level. Chic and varied pieces furniture are strategically placed throughout, creating many small comfortable pockets for reclusive reading, Everything, including the stairs, is made with lustrous pieces of rich, polished mahogany. In the center of the dome, some distance away and to the west, you can see what looks to be the library's front desk, though it is hard to tell since the building is completely empty. 

You can see an unusual door here.

You can go east through the unusual door to the Narrow Corridor and west from here.

* * *

>take air
Taken.

>examine air
You see nothing special about the still air.

* * *

>take east door sign
Taken.

>drop each door sign
(the east door sign)
Dropped.

>take air
Taken.

* * *

>n
Hallway
This is a long hallway that seems to stretch endlessly in either direction.  It is reminiscent of the halls that one might see in a fancy hotel; identical doors are spaced regularly along the walls on either side, each of which are outfitted with a black box above the handle designed to accept a key card. The walls are papered with a rich navy and powder-blue damask pattern, and a tightly knitted carpet frames the passage, tracing muted grey and gold stripes down its length.  The air feels unnaturally still here.

You can go north, south to the Hallway, east and west from here.

>n
Even More Hallway
You are in a long hallway.  Identical doors are spaced regularly along the walls on either side. Many of the doors are closed and locked, but there are two doors to your immediate left and right (east and west) that are slightly ajar, and you can see two similar doors further down the hallway. The wall paper is a rich navy and powder-blue damask pattern. Combined with the dark wooden wainscotting, it gives the hallways an unnderving air of false comfort, with vauge suggestions of austerity. Near the east door, there is a spot on the wall where the wallpaper is peeling. You see a torn piece.

A neat section of the blue damask wall paper has torn, revealing a patch of yellow beneath it. You admire the torn piece.

>s
More Hallway
You are in a long hallway.  Identical doors are spaced regularly along the walls on either side. Each door has a sign beside it bearing a room number. There are two doors to your immediate left and right (east and west).

* * *

>n
Yet More Hallway
You are in a long hallway.  Identical doors are spaced regularly along the walls on either side.  Many of the doors are closed and locked, but there are two doors to your immediate left and right (east and west) that are slightly ajar, and you can see two similar doors further down the hallway. The wall paper is a rich navy and powder-blue damask pattern. Combined with the dark wooden wainscotting, it gives the hallway an unnderving air of false comfort, with vauge suggestions of austerity. You can see the end of the hallway to the north.

>n
Hallway End
The hallway ends here. There are doors to the north, east, and west.

>e
Outside Room
Opening the door reveals what at first looks to be a wide outdoor space, filled with shrubs and grasses. A fog hangs in the air above you, obscuring the view upward. The illusion is broken by many white pillars holding up what must be a distant cieling. In the center of this large room is a small house.

>inside
Play House
This house would be very cozy, if it weren't sized for children. There is a kitchen, complete with a plastic stove and refrigerator, and a living room which contains a small throw rug and a picture of a television. There are many clocks drawn on the walls in crayon, each telling different times.

* * *

>n
Yet More Hallway
You are in a long hallway.  Identical doors are spaced regularly along the walls on either side.  Many of the doors are closed and locked, but there are two doors to your immediate left and right (east and west) that are slightly ajar, and you can see two similar doors further down the hallway. The wall paper is a rich navy and powder-blue damask pattern. Combined with the dark wooden wainscotting, it gives the hallway an unnderving air of false comfort, with vauge suggestions of austerity. You can see the end of the hallway to the north.

>e
You can't go that way.

* * *

>w
You can't go that way.

>n
Hallway End
The hallway ends here. There are doors to the north, east, and west.

* * *

>e
Outside Room
Opening the door reveals what at first looks to be a wide outdoor space, filled with shrubs and grasses. A fog hangs in the air above you, obscuring the view upward. The illusion is broken by many white pillars holding up what must be a distant cieling. In the center of this large room is a small house.

>inside
Play House

* * *

>n
Yet More Hallway
You are in a long hallway.  Identical doors are spaced regularly along the walls on either side.  Many of the doors are closed and locked, but there are two doors to your immediate left and right (east and west) that are slightly ajar, and you can see two similar doors further down the hallway. The wall paper is a rich navy and powder-blue damask pattern. Combined with the dark wooden wainscotting, it gives the hallway an unnderving air of false comfort, with vauge suggestions of austerity. You can see the end of the hallway to the north.

>w
Old Mall
The hallway opens up into what appears to be an empty shopping mall. There is a high domed cieling with skylights overhead. The floor transitions from the carpeted hallway to over-large tan octagonal tiles. They air is cool here and slightly more humid, as if there were a water source nearby. You think you may even hear the distant trickle of water. A few small trees can be seen in planters, spaced decoratively. In contrast to the tense and silent hallway, this space is pleasant and serene. You can see the entrance to several shops. The Ordinary Shop is to the northeast, the Extraordinary Shop is to the northwest, and The Lonely and Dark stores are to the east and west respectively. There is also an escalator leading up to a second floor.

>e
Yet More Hallway
You are in a long hallway.  Identical doors are spaced regularly along the walls on either side.  Many of the doors are closed and locked, but there are two doors to your immediate left and right (east and west) that are slightly ajar, and you can see two similar doors further down the hallway. The wall paper is a rich navy and powder-blue damask pattern. Combined with the dark wooden wainscotting, it gives the hallway an unnderving air of false comfort, with vauge suggestions of austerity. You can see the end of the hallway to the north.

>e
You can't go that way.

>s
Even More Hallway
You are in a long hallway.  Identical doors are spaced regularly along the walls on either side. Many of the doors are closed and locked, but there are two doors to your immediate left and right (east and west) that are slightly ajar, and you can see two similar doors further down the hallway. The wall paper is a rich navy and powder-blue damask pattern. Combined with the dark wooden wainscotting, it gives the hallways an unnderving air of false comfort, with vauge suggestions of austerity. Near the east door, there is a spot on the wall where the wallpaper is peeling. You see a torn piece.

A neat section of the blue damask wall paper has torn, revealing a patch of yellow beneath it. You admire the torn piece.

>w
Bedroom
This looks like a bedroom. There is a bed, a wardrobe, and a mirror. There is also a small night light plugged into an outlet in the wall.

 The night light is off.

You can also see a wardrobe (closed) and a cabinet (closed) here.

>e
Even More Hallway
You are in a long hallway.  Identical doors are spaced regularly along the walls on either side. Many of the doors are closed and locked, but there are two doors to your immediate left and right (east and west) that are slightly ajar, and you can see two similar doors further down the hallway. The wall paper is a rich navy and powder-blue damask pattern. Combined with the dark wooden wainscotting, it gives the hallways an unnderving air of false comfort, with vauge suggestions of austerity. Near the east door, there is a spot on the wall where the wallpaper is peeling. You see a torn piece.

A neat section of the blue damask wall paper has torn, revealing a patch of yellow beneath it. You admire the torn piece.

>e
Drinking Room
This room is fully furnished including a white fainting couch, a grandfather clock, and a coffee table. All of the furniture is made of the same dark, rich wood that can be found throughout. On the wall there is a full-sized mirror and a large painting of a woman. In the northeast corner you can see a small metal gate stretched across a doorway. You think you can hear a faint ticking sound.

There is a fully stocked bar in the corner. It is has a beautiful curved countertop and many shelves of liqours which reach to the cieling behind it. Almost all of the bottles are brand new and sealed.

On the bar are a bottle of whiskey, a bottle of vodka, a bottle of gin and a lemon.

You can see a grandfather clock here.

You can also see a metal gate here.

>open clock
You open the grandfather clock, revealing a pendulum.

>take pendulum
Taken.

>examine pendulum
It writhes menacingly.

* * *

>n
Hallway
This is a long hallway that seems to stretch endlessly in either direction.  It is reminiscent of the halls that one might see in a fancy hotel; identical doors are spaced regularly along the walls on either side, each of which are outfitted with a black box above the handle designed to accept a key card. The walls are papered with a rich navy and powder-blue damask pattern, and a tightly knitted carpet frames the passage, tracing muted grey and gold stripes down its length.  The air feels unnaturally still here.

You can go north, south to the Hallway, east and west from here.

>s
You can't go that way.

* * *

>n
Hallway
This is a long hallway that seems to stretch endlessly in either direction.  It is reminiscent of the halls that one might see in a fancy hotel; identical doors are spaced regularly along the walls on either side, each of which are outfitted with a black box above the handle designed to accept a key card. The walls are papered with a rich navy and powder-blue damask pattern, and a tightly knitted carpet frames the passage, tracing muted grey and gold stripes down its length.  The air feels unnaturally still here.

You can go north, south to the Hallway, east and west from here.

>e
Place Where you Shouldn't Be
This is a square room with little ornamentation. You feel as if you shouldn't be here.

You can see a black door here.

You can go north through the black door (closed) and west to the Hallway from here.

>w
Hallway
This is a long hallway that seems to stretch endlessly in either direction.  It is reminiscent of the halls that one might see in a fancy hotel; identical doors are spaced regularly along the walls on either side, each of which are outfitted with a black box above the handle designed to accept a key card. The walls are papered with a rich navy and powder-blue damask pattern, and a tightly knitted carpet frames the passage, tracing muted grey and gold stripes down its length.  The air feels unnaturally still here.

You can go north, south to the Hallway, east to the Place Where you Shouldn't Be and west from here.

>w
Foyer
Despite being an isolated room in the middle of a hallway, this room appears to be a foyer. There is a small sofa and a shoe rack along the west wall. On the north wall, there is a clock. There is a staircase in the northwest corner leading down. The bottom of the stairs is in darkness, but you think you percieve the vague outline of a person there.

You can see a shoe rack (on which is a pair of women's heels) here.

You can go northwest and east to the Hallway from here.

>e
Hallway
This is a long hallway that seems to stretch endlessly in either direction.  It is reminiscent of the halls that one might see in a fancy hotel; identical doors are spaced regularly along the walls on either side, each of which are outfitted with a black box above the handle designed to accept a key card. The walls are papered with a rich navy and powder-blue damask pattern, and a tightly knitted carpet frames the passage, tracing muted grey and gold stripes down its length.  The air feels unnaturally still here.

You can go north, south to the Hallway, east to the Place Where you Shouldn't Be and west to the Foyer from here.

>n
Hallway
You are standing in the middle a long hallway that seems to stretch endlessly in either direction.  It is reminiscent of the halls that one might see in a fancy hotel; identical doors are spaced regularly along the walls on either side, each of which are outfitted with a black box above the handle designed to accept a key card. The walls are papered with a rich navy and powder-blue damask pattern, and a tightly knitted carpet frames the passage, tracing muted grey and gold stripes down its length.  The air feels unnaturally still here.

A steel knife is embedded in the wall nearby.

A neat section of the blue damask wall paper has torn, revealing a patch of yellow beneath it. You admire the torn piece.

You can go north, south to the Hallway, east and west from here.

>w
Bedroom
This looks like a child's bedroom.

There is a framed text on the wall. It looks like a nursery rhyme.

Against the far wall is a small white nightstand with a single drawer.

On the nightstand is an ornamental box.

You can also see a wardrobe and a cabinet here.

You can go east to the Hallway from here.

>read rhyme
ELORA 

Elora keeps a tiny box beside her bed. 
And every night when she retires,
she pulls a sticky silver thread
straight between her eyes and out her forehead.
 
At length, she's pulled a dozen feet or so.
She tears it off between her teeth,
and bundles it around her thumbs,
and in the box it goes.

Like spider silk, the substance soon restores.
Each night she must extract a little more.
A bit of string's no burden on a box,
but soon it filled to bursting, so she fetched the locks.

A key for a lock, a box for a key, a lid for the box that held it.
A second, a third, and every box so full she could barely close it.
A fortnight or two and she's bricked herself completely into her room.
Then over the balcony the boxes go 'till she's bricked her windows too.

Then at last a night came she had no place left to keep it.
The sticky substance filled her head; she'd no choice but to see it.
 And then it filled her up so much it dripped into her eyes.
And across her vision cast a veil of webby spider ties.

>open wardrobe
You open the wardrobe, revealing many tiny boxes.

>open drawer
You open the drawer, revealing many tiny keys.

>feel tension
You are a little tense.

* * *

>n
Hallway
This is a long hallway that seems to stretch endlessly in either direction.  It is reminiscent of the halls that one might see in a fancy hotel; identical doors are spaced regularly along the walls on either side, each of which are outfitted with a black box above the handle designed to accept a key card. The walls are papered with a rich navy and powder-blue damask pattern, and a tightly knitted carpet frames the passage, tracing muted grey and gold stripes down its length.  The air feels unnaturally still here.

You can go north, south to the Hallway, east and west from here.

>w
Extraordinary Room
This room is completely dark.

You can see something here.

You can go east to the Old Mall from here.

>w
You can't go that way.

>e
Old Mall
The hallway opens up into what appears to be an empty shopping mall. There is a high domed cieling with skylights overhead. The floor transitions from the carpeted hallway to over-large tan octagonal tiles. They air is cool here and slightly more humid, as if there were a water source nearby. You think you may even hear the distant trickle of water. A few small trees can be seen in planters, spaced decoratively. In contrast to the tense and silent hallway, this space is pleasant and serene. You can see the entrance to several shops. The Ordinary Shop is to the northeast, the Extraordinary Shop is to the northwest, and The Lonely and Dark stores are to the east and west respectively. There is also an escalator leading up to a second floor.

You can go north, south to the Lonely Room, southwest, east, west to the Extraordinary Room and up from here.

* * *

>n
Hallway
This is a long hallway that seems to stretch endlessly in either direction.  It is reminiscent of the halls that one might see in a fancy hotel; identical doors are spaced regularly along the walls on either side, each of which are outfitted with a black box above the handle designed to accept a key card. The walls are papered with a rich navy and powder-blue damask pattern, and a tightly knitted carpet frames the passage, tracing muted grey and gold stripes down its length.  The air feels unnaturally still here.

You can go north, south to the Hallway, east and west from here.

>ne
(first opening the metal gate)
It seems to be locked.

* * *

>n
Hallway
This is a long hallway that seems to stretch endlessly in either direction.  It is reminiscent of the halls that one might see in a fancy hotel; identical doors are spaced regularly along the walls on either side, each of which are outfitted with a black box above the handle designed to accept a key card. The walls are papered with a rich navy and powder-blue damask pattern, and a tightly knitted carpet frames the passage, tracing muted grey and gold stripes down its length.  The air feels unnaturally still here.

You can go north, south to the Hallway, east and west from here.

>look
Machine Room
There is a grey button, a red button, and a red lever on the machine.

You can also see a tack-barrier here.

You can go north through the tack-barrier (closed) and east from here.

* * *

>n
Hallway
This is a long hallway that seems to stretch endlessly in either direction.  It is reminiscent of the halls that one might see in a fancy hotel; identical doors are spaced regularly along the walls on either side, each of which are outfitted with a black box above the handle designed to accept a key card. The walls are papered with a rich navy and powder-blue damask pattern, and a tightly knitted carpet frames the passage, tracing muted grey and gold stripes down its length.  The air feels unnaturally still here.

You can go north, south to the Hallway, east and west from here.

>open tack-barrier
You can't see any such thing.

* * *

>n
Hallway
This is a long hallway that seems to stretch endlessly in either direction.  It is reminiscent of the halls that one might see in a fancy hotel; identical doors are spaced regularly along the walls on either side, each of which are outfitted with a black box above the handle designed to accept a key card. The walls are papered with a rich navy and powder-blue damask pattern, and a tightly knitted carpet frames the passage, tracing muted grey and gold stripes down its length.  The air feels unnaturally still here.

You can go north, south to the Hallway, east and west from here.

>close tack-berrier
You can't see any such thing.

>e
Indistinguishable Corridors
You are in an empty corridor like many others. The wallpaper is yellow here.

These hallways are identical. You panic. You have lost your sense of direction.

>w
Machine Room
There is a grey button, a red button, and a red lever on the machine.

You can also see a tack-barrier here.

You can go north through the tack-barrier (closed) and east to Indistinguishable Corridors from here.

>close tack-barrier
That's already closed.

* * *

>n
Hallway
This is a long hallway that seems to stretch endlessly in either direction.  It is reminiscent of the halls that one might see in a fancy hotel; identical doors are spaced regularly along the walls on either side, each of which are outfitted with a black box above the handle designed to accept a key card. The walls are papered with a rich navy and powder-blue damask pattern, and a tightly knitted carpet frames the passage, tracing muted grey and gold stripes down its length.  The air feels unnaturally still here.

You can go north, south to the Hallway, east and west from here.

>open tack barrier
You can't see any such thing.

>open tack-barrier
It isn't something you can open.

* * *

>open stove
You can't see any such thing.

>examine stove
You can't see any such thing.

* * *

>press blue button
It is fixed in place.

>pull lever
That's already off.

>examine machine
The machine is currently switched off.

>examine lever
The red lever is currently switched off.

>examine machine
The machine is currently switched off.

* * *

>e
Old Mall
The hallway opens up into what appears to be an empty shopping mall. There is a high domed cieling with skylights overhead. The floor transitions from the carpeted hallway to over-large tan octagonal tiles. They air is cool here and slightly more humid, as if there were a water source nearby. You think you may even hear the distant trickle of water. A few small trees can be seen in planters, spaced decoratively. In contrast to the tense and silent hallway, this space is pleasant and serene. You can see the entrance to several shops. The Ordinary Shop is to the northeast, the Extraordinary Shop is to the northwest, and The Lonely and Dark stores are to the east and west respectively. There is also an escalator leading up to a second floor.

You can go north, south, southwest, east, west to the Extraordinary Room and up from here.

>w
Extraordinary Room
This room is mostly dark.

You sense that something is here.

You can go east to the Old Mall from here.

>push blue button
nothing seems to have happened

>push red button
You switch the machine on.

>push blue button
You hear a terrible whirring sound, and feel a passing wave of nausia.

>w
You can't go that way.

>e
Indistinguishable Corridors
You are in an empty corridor like many others. The wallpaper is powder-blue here.

These hallways are identical. You panic. You have lost your sense of direction.

* * *

>w
Extraordinary Room
This room is mostly dark.

You sense that something is here.

You can go east to the Old Mall from here.

>wait
Something tells you  (put conditional here later)

>take something
You grope around in the dark for a while, but cannot find it.

* * *

>wait
Something tells you  (put conditional here later)

>listen
Something tells you (put something here later)

>e
Something tells you (put something here later)

>w
Something tells you (put something here later)

>n
You can't go that way.

* * *

>s
You can't go that way.

>look
Extraordinary Room
This room is completely dark.

You can see something here.

You can go east from here.

>e
Something tells you (put something here later)

* * *

>wait
Something tells you  (put conditional here later)

>take something
You can't see any such thing.

* * *

>i
You are carrying:
  a booze
  a solutions manual

>look at booze
You see nothing special about the booze.

* * *

>s
You walk some distance down the length of the hallway until you arrive at the next set of adjacent doors

Hallway
You are standing in the middle a long hallway that seems to stretch endlessly in either direction.  It is reminiscent of the halls that one might see in a fancy hotel; identical doors are spaced regularly along the walls on either side, each of which are outfitted with a black box above the handle designed to accept a key card. The walls are papered with a rich navy and powder-blue damask pattern, and a tightly knitted carpet frames the passage, tracing muted grey and gold stripes down its length.  The air feels unnaturally still here.

You can go north to the Hallway, south, east and west from here.

>n
You walk some distance down the length of the hallway until you arrive at the next set of adjacent doors

Hallway
You can go north, south to the Hallway, east and west from here.

>look
You are in the main hallway. It stretches indefinitely in either direction. There are doors to your east and west.

* * *

>examine glasses
You see nothing special about the pair of glasses.

* * *

>take books
That's fixed in place.

* * *

>take book
You peruse the book titles. None of them stand out to you, so you decide to leave them alone.

>examine book
You see nothing special about the row of books.

>read book
There are no pages in the row of books.

* * *

>open stove
You open the stove, revealing a plastic turkey.

>take stove
Taken.

* * *

>open stove
You open the stove, revealing a plastic turkey.

>close stove
You close the stove.

* * *

>open stove
You open the stove, revealing a plastic turkey.

>examine turkey
Some things are exactly as they seem.

>take turkey
Taken.

>examine television
You watch imaginary news on the imaginary television for a while before becoming bored and giving up.

* * *

>s
...you walk some distance down the length of the hallway until you arrive at the next set of adjacent doors...

Hallway
This is a long hallway that seems to stretch endlessly in either direction.  It is reminiscent of the halls of a fancy hotel; identical doors are spaced regularly along the walls on either side, each of which are outfitted with a black box above the handle designed to accept a key card. The walls are papered with a rich navy and powder-blue damask pattern, and a tightly knitted carpet frames the passage, tracing muted grey and gold stripes down its length. The air feels unnaturally still 

You can go north, south, east and west from here.

>s
You walk some distance down the length of the hallway until you arrive at the next set of adjacent doors

test

>w
You can't go that way.

* * *

>e
You can't go that way.

>outside
Outside Room
Opening the door reveals what at first looks to be a wide outdoor space, filled with shrubs and grasses. A fog hangs in the air above you, obscuring the view upward. The illusion is broken by many white pillars holding up what must be a distant cieling. In the center of this large room is a small plastic house.

>n
You can't go that way.

>w
Hallway End
The hallway ends here. There are doors to the north, east, and west.

>n
Hallway
You are in a long hallway.  Identical doors are spaced regularly along the walls on either side. Each door has a sign beside it bearing a room number. There are two doors to your immediate left and right (east and west). The air feels unnaturally still here.

* * *

>s
You walk some distance down the length of the hallway until you arrive at the next set of adjacent doors

test

>;
That's not a verb I recognise.

>look
Hallway
You are standing in the middle a long hallway that seems to stretch endlessly in either direction.  It is reminiscent of the halls that one might see in a fancy hotel; identical doors are spaced regularly along the walls on either side, each of which are outfitted with a black box above the handle designed to accept a key card. The walls are papered with a rich navy and powder-blue damask pattern, and a tightly knitted carpet frames the passage, tracing muted grey and gold stripes down its length.  The air feels unnaturally still here.

You can go north to the Hallway, south and west from here.

>s
You walk some distance down the length of the hallway until you arrive at the next set of adjacent doors

Hallway
You are standing in the middle a long hallway that seems to stretch endlessly in either direction.  It is reminiscent of the halls that one might see in a fancy hotel; identical doors are spaced regularly along the walls on either side, each of which are outfitted with a black box above the handle designed to accept a key card. The walls are papered with a rich navy and powder-blue damask pattern, and a tightly knitted carpet frames the passage, tracing muted grey and gold stripes down its length.  The air feels unnaturally still here.

A steel knife is embedded in the wall nearby.

A neat section of the blue damask wall paper has torn, revealing a patch of yellow beneath it. You admire the torn piece.

You can go north to the Hallway, south, east and west from here.

>s
You walk some distance down the length of the hallway until you arrive at the next set of adjacent doors

Hallway
This is a long hallway that seems to stretch endlessly in either direction.  It is reminiscent of the halls that one might see in a fancy hotel; identical doors are spaced regularly along the walls on either side, each of which are outfitted with a black box above the handle designed to accept a key card. The walls are papered with a rich navy and powder-blue damask pattern, and a tightly knitted carpet frames the passage, tracing muted grey and gold stripes down its length.  The air feels unnaturally still here.

You can go north to the Hallway, south to the Hallway, east and west from here.

>s
You walk some distance down the length of the hallway until you arrive at the next set of adjacent doors

Hallway
You are standing in the middle a long hallway that seems to stretch endlessly in either direction.  It is reminiscent of the halls that one might see in a fancy hotel; identical doors are spaced regularly along the walls on either side, each of which are outfitted with a black box above the handle designed to accept a key card. The walls are papered with a rich navy and powder-blue damask pattern, and a tightly knitted carpet frames the passage, tracing muted grey and gold stripes down its length.  The air feels unnaturally still here.

You can go north to the Hallway, south to the Hallway, east and west from here.

>s
You walk some distance down the length of the hallway until you arrive at the next set of adjacent doors

Hallway
You are standing in the middle a long hallway that seems to stretch endlessly in either direction.  It is reminiscent of the halls that one might see in a fancy hotel; identical doors are spaced regularly along the walls on either side, each of which are outfitted with a black box above the handle designed to accept a key card. The walls are papered with a rich navy and powder-blue damask pattern, and a tightly knitted carpet frames the passage, tracing muted grey and gold stripes down its length.  The air feels unnaturally still here.

You can go north to the Hallway, south to the Hallway, east and west from here.

>s
You walk some distance down the length of the hallway until you arrive at the next set of adjacent doors

Hallway
You are standing in the middle a long hallway that seems to stretch endlessly in either direction.  It is reminiscent of the halls that one might see in a fancy hotel; identical doors are spaced regularly along the walls on either side, each of which are outfitted with a black box above the handle designed to accept a key card. The walls are papered with a rich navy and powder-blue damask pattern, and a tightly knitted carpet frames the passage, tracing muted grey and gold stripes down its length.  The air feels unnaturally still here.

You can go north to the Hallway, south to the Hallway and west from here.

>s
You walk some distance down the length of the hallway until you arrive at the next set of adjacent doors

Hallway
You are standing in the middle a long hallway that seems to stretch endlessly in either direction.  It is reminiscent of the halls that one might see in a fancy hotel; identical doors are spaced regularly along the walls on either side, each of which are outfitted with a black box above the handle designed to accept a key card. The walls are papered with a rich navy and powder-blue damask pattern, and a tightly knitted carpet frames the passage, tracing muted grey and gold stripes down its length.  The air feels unnaturally still here.

A steel knife is embedded in the wall nearby.

A neat section of the blue damask wall paper has torn, revealing a patch of yellow beneath it. You admire the torn piece.

You can go north to the Hallway, south to the Hallway, east and west from here.

>s
You walk some distance down the length of the hallway until you arrive at the next set of adjacent doors

Hallway
This is a long hallway that seems to stretch endlessly in either direction.  It is reminiscent of the halls that one might see in a fancy hotel; identical doors are spaced regularly along the walls on either side, each of which are outfitted with a black box above the handle designed to accept a key card. The walls are papered with a rich navy and powder-blue damask pattern, and a tightly knitted carpet frames the passage, tracing muted grey and gold stripes down its length.  The air feels unnaturally still here.

You can go north to the Hallway, south to the Hallway, east and west from here.

* * *

>n
...you walk some distance down the length of the hallway until you arrive at the next set of adjacent doors...

Hallway
This is a long hallway that seems to stretch endlessly in either direction.  It is reminiscent of the halls of a fancy hotel; identical doors are spaced regularly along the walls on either side, each of which are outfitted with a black box above the handle designed to accept a key card. The walls are papered with a rich navy and powder-blue damask pattern, and a tightly knitted carpet frames the passage, tracing muted grey and gold stripes down its length. The air feels unnaturally still 

You can go north, south to the Hallway, east and west from here.

>w
You can't go that way.

* * *

>e
You can't go that way.

>s
Indistinguishable Corridors
You are in an empty corridor like many others. The wallpaper is yellow here.

You can go north to Indistinguishable Corridors and south from here.

>n
Indistinguishable Corridors
You are in an empty corridor like many others. The wallpaper is yellow here.

You can go south to Indistinguishable Corridors from here.

>s
Indistinguishable Corridors
You are in an empty corridor like many others. The wallpaper is yellow here.

You can go north to Indistinguishable Corridors and south from here.

>e
You can't go that way.

* * *

>w
You can't go that way.

>n
Indistinguishable Corridors
You are in an empty corridor like many others. The wallpaper is yellow here.

You can go south to Indistinguishable Corridors from here.

>w
You can't go that way.

* * *

>e
You can't go that way.

>n
You can't go that way.

>s
Indistinguishable Corridors
You are in an empty corridor like many others. The wallpaper is yellow here.

You can go north to Indistinguishable Corridors and south from here.

>w
You can't go that way.

>s
Indistinguishable Corridors
You are in an empty corridor like many others. The wallpaper is yellow here.

You can go north to Indistinguishable Corridors and east from here.

>w
You can't go that way.

>e
Indistinguishable Corridors
You are in an empty corridor like many others. The wallpaper is yellow here.

You can go north, south, east and west to Indistinguishable Corridors from here.

* * *

>n
...you walk some distance down the length of the hallway until you arrive at the next set of adjacent doors...

Hallway
This is a long hallway that seems to stretch endlessly in either direction.  It is reminiscent of the halls of a fancy hotel; identical doors are spaced regularly along the walls on either side, each of which are outfitted with a black box above the handle designed to accept a key card. The walls are papered with a rich navy and powder-blue damask pattern, and a tightly knitted carpet frames the passage, tracing muted grey and gold stripes down its length. The air feels unnaturally still 

You can go north, south to the Hallway, east and west from here.

>s
...you walk some distance down the length of the hallway until you arrive at the next set of adjacent doors...

Hallway
You are in the main hallway. It stretches indefinitely in either direction. There are doors to your east and west.

You can go north to the Hallway, south to the Hallway, east and west from here.

>e
Records Room
This is an austere looking room with beige tile floors below and white flourescent lighting overhead. A number of file cabinets line the north and south walls. In the furthest corner is a grey metal desk with two locking drawers and a bankers lamp with a green glass shade. It is uncomfortably warm in here. In the corner, a standing metal fan is noisily failing to cool it.

You can see a metal fan and some file cabinets here.

You can go east and west to the Hallway from here.

* * *

>e
Yet More Hallway
You are in a long hallway.  Identical doors are spaced regularly along the walls on either side.  Many of the doors are closed and locked, but there are two doors to your immediate left and right (east and west) that are slightly ajar, and you can see two similar doors further down the hallway. The wall paper is a rich navy and powder-blue damask pattern. Combined with the dark wooden wainscotting, it gives the hallway an unnderving air of false comfort, with vauge suggestions of austerity. You can see the end of the hallway to the north. 

You can go north, south and west to the Old Mall from here.

>n
Hallway End
The hallway seems to end here. There are doors to the north, east, and west. There is something deeply disquieting about the doorway to the north, ordinary as it appears.

You can go north, south to the Yet More Hallway, east and west from here.

* * *

>w
Hallway End
The hallway seems to end here. There are doors to the north, east, and west. There is something deeply disquieting about the doorway to the north, ordinary as it appears.

You can go north, south to the Yet More Hallway, east to the Outside Room and west to the Empty Corridor from here.

>s
Yet More Hallway
You are in a long hallway.  Identical doors are spaced regularly along the walls on either side.  Many of the doors are closed and locked, but there are two doors to your immediate left and right (east and west) that are slightly ajar, and you can see two similar doors further down the hallway. The wall paper is a rich navy and powder-blue damask pattern. Combined with the dark wooden wainscotting, it gives the hallway an unnderving air of false comfort, with vauge suggestions of austerity. You can see the end of the hallway to the north. 

You can go north to the Hallway End, south and west to the Old Mall from here.

>s
Even More Hallway
You are in a long hallway.  Identical doors are spaced regularly along the walls on either side. Many of the doors are closed and locked, but there are two doors to your immediate left and right (east and west) that are slightly ajar, and you can see two similar doors further down the hallway. The wall paper is a rich navy and powder-blue damask pattern. Combined with the dark wooden wainscotting, it gives the hallways an unnderving air of false comfort, with vauge suggestions of austerity. Near the east door, there is a spot on the wall where the wallpaper is peeling. You see a torn piece.

A neat section of the blue damask wall paper has torn, revealing a patch of yellow beneath it. You admire the torn piece.

You can go north to the Yet More Hallway, south, east and west from here.

>e
Drinking Room
This room is fully furnished, with a white fainting couch, a grandfather-clock, and a coffee table. All of the furniture is made of the same dark, rich wood that can be found throughout. On the wall there is a full-sized mirror and a large painting of a woman. In the northeast corner you can see a small metal gate stretched across a doorway. You think you can hear a faint ticking sound.

There is a grandfather-clock here.

There is a fully stocked bar in the corner. It is has a beautiful curved countertop, and many shelves of liqours reach to the cieling behind it. Almost all of the bottles are brand new and sealed.

On the bar are a bottle of whiskey, a bottle of vodka, a bottle of gin and a lemon.

You can also see a metal gate here.

You can go northeast through the metal gate (closed) and west to the Even More Hallway from here.

>w
Even More Hallway
You are in a long hallway.  Identical doors are spaced regularly along the walls on either side. Many of the doors are closed and locked, but there are two doors to your immediate left and right (east and west) that are slightly ajar, and you can see two similar doors further down the hallway. The wall paper is a rich navy and powder-blue damask pattern. Combined with the dark wooden wainscotting, it gives the hallways an unnderving air of false comfort, with vauge suggestions of austerity. Near the east door, there is a spot on the wall where the wallpaper is peeling. You see a torn piece.

A neat section of the blue damask wall paper has torn, revealing a patch of yellow beneath it. You admire the torn piece.

You can go north to the Yet More Hallway, south, east to the Drinking Room and west from here.

>s
More Hallway
You are in a long hallway.  Identical doors are spaced regularly along the walls on either side. Many of the doors are closed and locked, but there are two doors to your immediate left and right (east and west) that are slightly ajar, and you can see two similar doors further down the hallway. The wall paper is a rich navy and powder-blue damask pattern. Combined with the dark wooden wainscotting, it gives the hallways an unnderving air of false comfort, with vauge suggestions of austerity.

You can go north to the Even More Hallway, south, east and west from here.

>e
You Shouldn't Be Here
This is a square room with little ornamentation. You feel as if you shouldn't be here.

You can see a black door here.

You can go north through the black door (closed) and west to the More Hallway from here.

>w
More Hallway
You are in a long hallway.  Identical doors are spaced regularly along the walls on either side. Many of the doors are closed and locked, but there are two doors to your immediate left and right (east and west) that are slightly ajar, and you can see two similar doors further down the hallway. The wall paper is a rich navy and powder-blue damask pattern. Combined with the dark wooden wainscotting, it gives the hallways an unnderving air of false comfort, with vauge suggestions of austerity.

You can go north to the Even More Hallway, south, east to the You Shouldn't Be Here and west from here.

>w
Foyer
Despite being an isolated room in the middle of a hallway, this room appears to be a foyer. There is a small sofa and a shoe rack along the west wall. On the north wall, there is a clock. There is a staircase in the northwest corner leading down. The bottom of the stairs is in darkness, but you think you percieve the vague outline of a person there.

You can see a shoe rack (on which is a pair of women's heels) here.

You can go northwest and east to the More Hallway from here.

>e
More Hallway
You are in a long hallway.  Identical doors are spaced regularly along the walls on either side. Many of the doors are closed and locked, but there are two doors to your immediate left and right (east and west) that are slightly ajar, and you can see two similar doors further down the hallway. The wall paper is a rich navy and powder-blue damask pattern. Combined with the dark wooden wainscotting, it gives the hallways an unnderving air of false comfort, with vauge suggestions of austerity.

You can go north to the Even More Hallway, south, east to the You Shouldn't Be Here and west to the Foyer from here.

>s
Hallway
You are in a long hallway.  Identical doors are spaced regularly along the walls on either side. Many of the doors are closed and locked, but there are two doors to your immediate left and right (east and west) that are slightly ajar, and you can see two similar doors further down the hallway. There a door to the south, and something about it is deeply disquieting, ordinary as it looks. The wall paper is a rich navy and powder-blue damask pattern. Combined with the dark wooden wainscotting, it gives the hallways an unnderving air of false comfort, with vauge suggestions of austerity.The air feels unnaturally still here.

You can go north to the More Hallway and south to the Hallway End from here.

>n
More Hallway
You are in a long hallway.  Identical doors are spaced regularly along the walls on either side. Many of the doors are closed and locked, but there are two doors to your immediate left and right (east and west) that are slightly ajar, and you can see two similar doors further down the hallway. The wall paper is a rich navy and powder-blue damask pattern. Combined with the dark wooden wainscotting, it gives the hallways an unnderving air of false comfort, with vauge suggestions of austerity.

You can go north to the Even More Hallway, south to the Hallway, east to the You Shouldn't Be Here and west to the Foyer from here.

>n
Even More Hallway
You are in a long hallway.  Identical doors are spaced regularly along the walls on either side. Many of the doors are closed and locked, but there are two doors to your immediate left and right (east and west) that are slightly ajar, and you can see two similar doors further down the hallway. The wall paper is a rich navy and powder-blue damask pattern. Combined with the dark wooden wainscotting, it gives the hallways an unnderving air of false comfort, with vauge suggestions of austerity. Near the east door, there is a spot on the wall where the wallpaper is peeling. You see a torn piece.

A neat section of the blue damask wall paper has torn, revealing a patch of yellow beneath it. You admire the torn piece.

You can go north to the Yet More Hallway, south to the More Hallway, east to the Drinking Room and west from here.

>w
Bedroom
This looks like a bedroom. There is a bed, a wardrobe, and a mirror. There is also a small night light plugged into an outlet in the wall.

 The night light is off.

You can also see a wardrobe (closed) here.

You can go east to the Even More Hallway from here.

>e
Even More Hallway
You are in a long hallway.  Identical doors are spaced regularly along the walls on either side. Many of the doors are closed and locked, but there are two doors to your immediate left and right (east and west) that are slightly ajar, and you can see two similar doors further down the hallway. The wall paper is a rich navy and powder-blue damask pattern. Combined with the dark wooden wainscotting, it gives the hallways an unnderving air of false comfort, with vauge suggestions of austerity. Near the east door, there is a spot on the wall where the wallpaper is peeling. You see a torn piece.

A neat section of the blue damask wall paper has torn, revealing a patch of yellow beneath it. You admire the torn piece.

You can go north to the Yet More Hallway, south to the More Hallway, east to the Drinking Room and west to the Bedroom from here.

>n
Yet More Hallway
You are in a long hallway.  Identical doors are spaced regularly along the walls on either side.  Many of the doors are closed and locked, but there are two doors to your immediate left and right (east and west) that are slightly ajar, and you can see two similar doors further down the hallway. The wall paper is a rich navy and powder-blue damask pattern. Combined with the dark wooden wainscotting, it gives the hallway an unnderving air of false comfort, with vauge suggestions of austerity. You can see the end of the hallway to the north. 

You can go north to the Hallway End, south to the Even More Hallway and west to the Old Mall from here.

>n
Hallway End
The hallway seems to end here. There are doors to the north, east, and west. There is something deeply disquieting about the doorway to the north, ordinary as it appears.

You can go north to the Hallway, south to the Yet More Hallway, east to the Outside Room and west to the Empty Corridor from here.

>w
Empty Corridor
This is a long section of empty hallway. Further west, you see that the hallway diverges into similar looking corridors with no doors, no furniture and no ornamentation. You sense that if you keep going to the west, you may become lost. The wallpaper is yellow here.

You can go east to the Hallway End and west from here.

>w
Indistinguishable Corridors
You are in an empty corridor like many others. The wallpaper is yellow here.

These hallways are identical. You panic. You have lost your sense of direction.

>w
You can't go that way.

>s
Indistinguishable Corridors
You are in an empty corridor like many others. The wallpaper is yellow here.

These hallways are identical. You panic. You have lost your sense of direction.

>n
Indistinguishable Corridors
You are in an empty corridor like many others. The wallpaper is yellow here.

These hallways are identical. You panic. You have lost your sense of direction.

>n
You can't go that way.

>w
You can't go that way.

>e
Empty Corridor
This is a long section of empty hallway. Further west, you see that the hallway diverges into similar looking corridors with no doors, no furniture and no ornamentation. You sense that if you keep going to the west, you may become lost. The wallpaper is yellow here.

You can go east to the Hallway End and west to Indistinguishable Corridors from here.

* * *

>look
Hallway
You are standing in the middle a long hallway that seems to stretch endlessly in either direction.  It is reminiscent of the halls that one might see in a fancy hotel; identical doors are spaced regularly along the walls on either side, each of which are outfitted with a black box above the handle designed to accept a key card. The walls are papered with a rich navy and powder-blue damask pattern, and a tightly knitted carpet frames the passage, tracing muted grey and gold stripes down its length.  The air feels unnaturally still here.

You can go north, south to the Hallway, east and west from here.

>s
You walk some distance down the length of the hallway until you arrive at the next set of adjacent doors

test

>s
You walk some distance down the length of the hallway until you arrive at the next set of adjacent doors

test

>n
You walk some distance down the length of the hallway until you arrive at the next set of adjacent doors

test

>n
You walk some distance down the length of the hallway until you arrive at the next set of adjacent doors

test

>e
Outside Room
Opening the door reveals what at first looks to be a wide outdoor space filled with shrubs and grasses. A fog hangs in the air above you, obscuring the view upward. The illusion is broken by many white pillars holding up what must be a distant cieling. In the east corner of this large room is a small plastic house.

You can go east and west to the Hallway from here.

>w
Hallway
You are standing in the middle a long hallway that seems to stretch endlessly in either direction.  It is reminiscent of the halls that one might see in a fancy hotel; identical doors are spaced regularly along the walls on either side, each of which are outfitted with a black box above the handle designed to accept a key card. The walls are papered with a rich navy and powder-blue damask pattern, and a tightly knitted carpet frames the passage, tracing muted grey and gold stripes down its length.  The air feels unnaturally still here.

You can go north to the Hallway, south, east to the Outside Room and west from here.

>e
Outside Room
Opening the door reveals what at first looks to be a wide outdoor space filled with shrubs and grasses. A fog hangs in the air above you, obscuring the view upward. The illusion is broken by many white pillars holding up what must be a distant cieling. In the east corner of this large room is a small plastic house.

You can go east and west to the Hallway from here.

* * *

>n
You walk some distance down the length of the hallway until you arrive at the next set of adjacent doors

test

>s
You walk some distance down the length of the hallway until you arrive at the next set of adjacent doors

test

* * *

>n
You walk some distance down the length of the hallway until you arrive at the next set of adjacent doors

test

>w
Narrow Corridor
This narrow corridor branches off of the main hallway. There is a door to the west that looks slightly different from the others. The wood is richer and brighter, and it opens outward rather than inward. A brass plaque is posted on the wall next to it.

You can see an unusual door and a brass plaque here.

You can go east to the Hallway and west through the unusual door (closed) from here.

* * *

>examine hallway
You can't see any such thing.

>feel around
You can't see any such thing.

* * *

>s
...you walk some distance down the length of the hallway until you arrive at the next set of adjacent doors...

Hallway
You are standing in the middle a long hallway that seems to stretch endlessly in either direction.  It is reminiscent of the halls that one might see in a fancy hotel; identical doors are spaced regularly along the walls on either side, each of which are outfitted with a black box above the handle designed to accept a key card. The walls are papered with a rich navy and powder-blue damask pattern, and a tightly knitted carpet frames the passage, tracing muted grey and gold stripes down its length.  The air feels unnaturally still here.

You can go north to the Hallway, south, east and west from here.

>n
...you walk some distance down the length of the hallway until you arrive at the next set of adjacent doors...

Hallway
You are in the main hallway. It stretches indefinitely in either direction. There are doors to your east and west.

You can go north, south to the Hallway, east and west from here.

>s
...you walk some distance down the length of the hallway until you arrive at the next set of adjacent doors...

Hallway
You are standing in the middle a long hallway that seems to stretch endlessly in either direction.  It is reminiscent of the halls that one might see in a fancy hotel; identical doors are spaced regularly along the walls on either side, each of which are outfitted with a black box above the handle designed to accept a key card. The walls are papered with a rich navy and powder-blue damask pattern, and a tightly knitted carpet frames the passage, tracing muted grey and gold stripes down its length.  The air feels unnaturally still here.

You can go north to the Hallway, south, east and west from here.

* * *

>n
...you walk some distance down the length of the hallway until you arrive at the next set of adjacent doors...

Hallway
You are in the main hallway. It stretches indefinitely in either direction. There are doors to your east and west.

You can go north, south to the Hallway, east and west from here.

>look
This is a long hallway that seems to stretch endlessly in either direction.  It is reminiscent of the halls of a fancy hotel; identical doors are spaced regularly along the walls on either side, each of which are outfitted with a black box above the handle designed to accept a key card. The walls are papered with a rich navy and powder-blue damask pattern, and a tightly knitted carpet frames the passage, tracing muted grey and gold stripes down its length. The air feels unnaturally still 
The obvious exits are north, south (to the hallway), east and west.

>l
This is a long hallway that seems to stretch endlessly in either direction.  It is reminiscent of the halls of a fancy hotel; identical doors are spaced regularly along the walls on either side, each of which are outfitted with a black box above the handle designed to accept a key card. The walls are papered with a rich navy and powder-blue damask pattern, and a tightly knitted carpet frames the passage, tracing muted grey and gold stripes down its length. The air feels unnaturally still 
The obvious exits are north, south (to the hallway), east and west.

* * *

>e
Outside Room
Opening the door reveals what at first looks to be a wide outdoor space filled with shrubs and grasses. A fog hangs in the air above you, obscuring the view upward. The illusion is broken by many white pillars holding up what must be a distant cieling. In the east corner of this large room is a small plastic house.

You can go east and west to the Hallway End from here.

>w
Hallway End
The hallway seems to end here. There are doors to the north, east, and west. There is something deeply disquieting about the doorway to the north, ordinary as it appears.

You can go north to the Hallway, south, east to the Outside Room and west from here.

>w
Empty Corridor
This is a long section of empty hallway. Further west, you see that the hallway diverges into similar looking corridors with no doors, no furniture and no ornamentation. You sense that if you keep going to the west, you may become lost. The wallpaper is yellow here.

You can go east to the Hallway End and west from here.

>e
Hallway End
The hallway seems to end here. There are doors to the north, east, and west. There is something deeply disquieting about the doorway to the north, ordinary as it appears.

You can go north to the Hallway, south, east to the Outside Room and west to the Empty Corridor from here.

>n
Hallway
You are in a long hallway.  Identical doors are spaced regularly along the walls on either side. Many of the doors are closed and locked, but there are two doors to your immediate left and right (east and west) that are slightly ajar, and you can see two similar doors further down the hallway. There a door to the south, and something about it is deeply disquieting, ordinary as it looks. The wall paper is a rich navy and powder-blue damask pattern. Combined with the dark wooden wainscotting, it gives the hallways an unnderving air of false comfort, with vauge suggestions of austerity.The air feels unnaturally still here.

You can go north and south to the Hallway End from here.

* * *

>e
You can't go that way.

>n
More Hallway
You are in a long hallway.  Identical doors are spaced regularly along the walls on either side. Many of the doors are closed and locked, but there are two doors to your immediate left and right (east and west) that are slightly ajar, and you can see two similar doors further down the hallway. The wall paper is a rich navy and powder-blue damask pattern. Combined with the dark wooden wainscotting, it gives the hallways an unnderving air of false comfort, with vauge suggestions of austerity.

You can go north, south to the Hallway, east and west from here.

>w
Foyer
Despite being an isolated room in the middle of a hallway, this room appears to be a foyer. There is a small sofa and a shoe rack along the west wall. On the north wall, there is a clock. There is a staircase in the northwest corner leading down. The bottom of the stairs is in darkness, but you think you percieve the vague outline of a person there.

You can see a shoe rack here.

You can go northwest and east to the More Hallway from here.

>e
More Hallway
You are in a long hallway.  Identical doors are spaced regularly along the walls on either side. Many of the doors are closed and locked, but there are two doors to your immediate left and right (east and west) that are slightly ajar, and you can see two similar doors further down the hallway. The wall paper is a rich navy and powder-blue damask pattern. Combined with the dark wooden wainscotting, it gives the hallways an unnderving air of false comfort, with vauge suggestions of austerity.

You can go north, south to the Hallway, east and west to the Foyer from here.

>e
Place Where you Shouldn't Be
This is a square room with little ornamentation. You feel as if you shouldn't be here.

You can see a black door here.

You can go north through the black door (closed) and west to the More Hallway from here.

>w
More Hallway
You are in a long hallway.  Identical doors are spaced regularly along the walls on either side. Many of the doors are closed and locked, but there are two doors to your immediate left and right (east and west) that are slightly ajar, and you can see two similar doors further down the hallway. The wall paper is a rich navy and powder-blue damask pattern. Combined with the dark wooden wainscotting, it gives the hallways an unnderving air of false comfort, with vauge suggestions of austerity.

You can go north, south to the Hallway, east to the Place Where you Shouldn't Be and west to the Foyer from here.

>n
Even More Hallway
You are in a long hallway.  Identical doors are spaced regularly along the walls on either side. Many of the doors are closed and locked, but there are two doors to your immediate left and right (east and west) that are slightly ajar, and you can see two similar doors further down the hallway. The wall paper is a rich navy and powder-blue damask pattern. Combined with the dark wooden wainscotting, it gives the hallways an unnderving air of false comfort, with vauge suggestions of austerity. Near the east door, there is a spot on the wall where the wallpaper is peeling. You see a torn piece.

A neat section of the blue damask wall paper has torn, revealing a patch of yellow beneath it. You admire the torn piece.

You can go north, south to the More Hallway, east and west from here.

>e
Drinking Room
This room is fully furnished including a white fainting couch, a grandfather clock, and a coffee table. All of the furniture is made of the same dark, rich wood that can be found throughout. On the wall there is a full-sized mirror and a large painting of a woman. In the northeast corner you can see a small metal gate stretched across a doorway. You think you can hear a faint ticking sound.

There is a fully stocked bar in the corner. It is has a beautiful curved countertop and many shelves of liqours which reach to the cieling behind it. Almost all of the bottles are brand new and sealed.

On the bar are a bottle of whiskey, a bottle of vodka, a bottle of gin and a lemon.

You can see a grandfather clock here.

You can also see a metal gate here.

You can go northeast through the metal gate (closed) and west to the Even More Hallway from here.

>open clock
You open the grandfather clock, revealing a pendulum.

* * *

>take pendulum
Taken.

>examine pendulum
It is strangely familiar to you.

* * *

>outside
Outside Room
Opening the door reveals what at first looks to be a wide outdoor space, filled with shrubs and grasses. A fog hangs in the air above you, obscuring the view upward. The illusion is broken by many white pillars holding up what must be a distant cieling. In the center of this large room is a small plastic house.

>e
You can't go that way.

>w
Hallway End
The hallway seems to end here. There are doors to the north, east, and west. There is something deeply unnerving about the doorway to the north, ordinary as it appears.

>examine wall paper
You see nothing special about the wall paper.

>s
Yet More Hallway
You are in a long hallway.  Identical doors are spaced regularly along the walls on either side. Each door has a sign beside it bearing a room number. There are two doors to your immediate left and right (east and west). You can see the end of the hallway to the north.

>examine wall paper
You see nothing special about the wall paper.

* * *

>outside
Outside Room
Opening the door reveals what at first looks to be a wide outdoor space, filled with shrubs and grasses. A fog hangs in the air above you, obscuring the view upward. The illusion is broken by many white pillars holding up what must be a distant cieling. In the center of this large room is a small plastic house.

>w
Hallway End
The hallway seems to end here. There are doors to the north, east, and west. There is something deeply unnerving about the doorway to the north, ordinary as it appears.

>n
Hallway
You are in a long hallway.  Identical doors are spaced regularly along the walls on either side. Each door has a sign beside it bearing a room number. There are two doors to your immediate left and right (east and west). The air feels unnaturally still here.

>n
More Hallway
You are in a long hallway.  Identical doors are spaced regularly along the walls on either side. Each door has a sign beside it bearing a room number. There are two doors to your immediate left and right (east and west).

>n
Even More Hallway
You are in a long hallway.  Identical doors are spaced regularly along the walls on either side. Each door has a sign beside it bearing a room number. There are two doors to your immediate left and right (east and west).

The wallpaper is peeling here.

>n
Yet More Hallway
You are in a long hallway.  Identical doors are spaced regularly along the walls on either side. Each door has a sign beside it bearing a room number. There are two doors to your immediate left and right (east and west). You can see the end of the hallway to the north.

>n
Hallway End
The hallway seems to end here. There are doors to the north, east, and west. There is something deeply unnerving about the doorway to the north, ordinary as it appears.

>n
Hallway
You are in a long hallway.  Identical doors are spaced regularly along the walls on either side. Each door has a sign beside it bearing a room number. There are two doors to your immediate left and right (east and west). The air feels unnaturally still here.

* * *

>examine darkness
You look into the darkness. It feels as if it could open up.

>w
Hallway
You are in a long hallway.  Identical doors are spaced regularly along the walls on either side. Each door has a sign beside it bearing a room number. There are two doors to your immediate left and right (east and west). The air feels unnaturally still here.

>w
Room 125
The door opens to a completely dark room. You see nothing but the darkness.

* * *

>open darkness
You open the darkness, revealing a black key.

>look in darkness
The darkness is empty.

* * *

>open darkness
You open the darkness, revealing a black key.

>examine key
It is a black key. It frightens you.

>take key
Taken.

>w
You can't go that way.

>e
Hallway
You are in a long hallway.  Identical doors are spaced regularly along the walls on either side. Each door has a sign beside it bearing a room number. There are two doors to your immediate left and right (east and west). There a door to the south, and something about it is deeply disquieting, ordinary as it looks. The walls are papered. The air feels unnaturally still here.

>s
Hallway End
The hallway seems to end here. There are doors to the north, east, and west. There is something deeply disquieting about the doorway to the north, ordinary as it appears.

* * *

>n
Hallway
You are in a long hallway.  Identical doors are spaced regularly along the walls on either side. Each door has a sign beside it bearing a room number. There are two doors to your immediate left and right (east and west). There a door to the south, and something about it is deeply disquieting, ordinary as it looks. The walls are papered. The air feels unnaturally still here.

>n
More Hallway
You are in a long hallway.  Identical doors are spaced regularly along the walls on either side. Each door has a sign beside it bearing a room number. There are two doors to your immediate left and right (east and west). The walls are papered.

>e
Room 128
This is a square room with little ornamentation. You feel as if you shouldn't be here.

You can see a black door here.

>open door
It seems to be locked.

>open door with key
You unlock the black door.

>open door
You open the black door.

>s
You can't go that way.

>n
Walls
You step into the darkness, and become darkness. You must have lost consiousness, because you awaken standing on a slab of concrete that is four foot square. Around you on every side are grey brick walls that stretch up indefinitely. Your fear resolves into a grim sense of familiarity, as a burden lifts from your shoulders.

* * *

>open darkness
You open the darkness, revealing a black key.

>examine darkness
You look into the darkness. It feels as if it could open up.

In the darkness is a black key.

>close darkness
You close the darkness.

>examine darkness
The yawning darkness is open all around you.

* * *

>open darkness
You open the darkness, revealing a black key.

>take key
Taken.

>examine darkness
The yawning darkness is all around you.

>close darkness
You close the darkness.

* * *

>scream
That's not a verb I recognise.

>look
Darkness
It is pitch dark, and you can't see a thing.

>n
You can't go that way.

>e
You can't go that way.

>w
Hallway
You are in a long hallway.  Identical doors are spaced regularly along the walls on either side. Each door has a sign beside it bearing a room number. There are two doors to your immediate left and right (east and west). The air feels unnaturally still here.

>n
More Hallway
You are in a long hallway.  Identical doors are spaced regularly along the walls on either side. Each door has a sign beside it bearing a room number. There are two doors to your immediate left and right (east and west).

* * *

>n
Even More Hallway
You are in a long hallway.  Identical doors are spaced regularly along the walls on either side. Each door has a sign beside it bearing a room number. There are two doors to your immediate left and right (east and west).

The wallpaper is peeling here.

>cast spell
That's not a verb I recognise.

* * *

>open toy box
It isn't something you can open.

* * *

>take stove
That's fixed in place.

* * *

>examine television
You see nothing special about the drawing of a television.

* * *

>examine wallpaper
You can't see any such thing.

>examine wall paper
The wall paper is a rich navy and powder-blue damask pattern. It is beautiful, but strangely forboding.

* * *

>examine clocks
Many clocks of different colors are drawn on the walls in crayon. They each tell different times, but strangely, you have trouble reading any of them.

>take clocks
That's hardly portable.

>take television
That's hardly portable.

>examine television
You see nothing special about the drawing of a television.

* * *

>examine refrigerator
You see nothing special about the refrigerator.

>take chair
That's hardly portable.

>take rug
That's hardly portable.

>read clocks
Many clocks of different colors are drawn on the walls in crayon. They each tell different times, but strangely, you have trouble reading any of them.

* * *

>examine wall paper
The wall paper is a rich navy and powder-blue damask pattern. Combined with the dark wooden wainscotting, it gives the hallway an unnderving air of false comfort, with vauge suggestions of austerity.

>s
More Hallway
You are in a long hallway.  Identical doors are spaced regularly along the walls on either side. Each door has a sign beside it bearing a room number. There are two doors to your immediate left and right (east and west).

>examine wall paper
The wall paper is a rich navy and powder-blue damask pattern. It is peeling here.

>s
Hallway
You are in a long hallway.  Identical doors are spaced regularly along the walls on either side. Each door has a sign beside it bearing a room number. There are two doors to your immediate left and right (east and west). The air feels unnaturally still here.

>examine wall paper
The wall paper is a rich navy and powder-blue damask pattern. It is peeling here.

>take torn paper
That's hardly portable.

* * *

>examine wall paper
The wall paper is a rich navy and powder-blue damask pattern. Combined with the dark wooden wainscotting, it gives the hallway an unnderving air of false comfort, with vauge suggestions of austerity.

>take piece
That's hardly portable.

>examine piece
A torn piece of wall paper hangs limply from the wall.

* * *

>examine torn piece
I only understood you as far as wanting to examine the torn paper.

>examine torn paper
The wall paper is a rich navy and powder-blue damask pattern. It is peeling here.

* * *

>take piece
That's hardly portable.

>examine piece
The wall paper is a rich navy and powder-blue damask pattern.

* * *

>examine piece
A torn piece of wall paper hangs limply from the wall.

>take piece
Taken.

* * *

>examine tension
You can feel a persistant, inesplicable tension in the air.

>take tension
That's hardly portable.

* * *

>take wall paper
That's hardly portable.

* * *

>examine paper
The wall paper is a rich navy and powder-blue damask pattern. Combined with the dark wooden wainscotting, it gives the hallways an unnderving air of false comfort, with vauge suggestions of austerity.

* * *

>enter house
Play House
This house would be very cozy if it weren't sized for children. There is a kitchenette complete with a table, plastic stove and refrigerator, and a living room which contains a chair, a small throw rug, and a well-drawn picture of a television. There are many clocks drawn on the walls in crayon, each telling different times.

A little plastic stove that opens and closes.

A plastic refrigerator that opens and closes.

You can also see a table (on which is a plastic toaster) here.

You can go west to the Outside Room from here.

>examine house
You see a plastic house. You consider going inside. *hint: type "inside"

>inside
Play House
This house would be very cozy if it weren't sized for children. There is a kitchenette complete with a table, plastic stove and refrigerator, and a living room which contains a chair, a small throw rug, and a well-drawn picture of a television. There are many clocks drawn on the walls in crayon, each telling different times.

A little plastic stove that opens and closes.

A plastic refrigerator that opens and closes.

You can also see a table (on which is a plastic toaster) here.

>outside
Outside Room
Opening the door reveals what at first looks to be a wide outdoor space filled with shrubs and grasses. A fog hangs in the air above you, obscuring the view upward. The illusion is broken by many white pillars holding up what must be a distant cieling. In the center of this large room is a small plastic house.

>go inside
Play House
This house would be very cozy if it weren't sized for children. There is a kitchenette complete with a table, plastic stove and refrigerator, and a living room which contains a chair, a small throw rug, and a well-drawn picture of a television. There are many clocks drawn on the walls in crayon, each telling different times.

A little plastic stove that opens and closes.

A plastic refrigerator that opens and closes.

You can also see a table (on which is a plastic toaster) here.

>go outside
Outside Room
Opening the door reveals what at first looks to be a wide outdoor space filled with shrubs and grasses. A fog hangs in the air above you, obscuring the view upward. The illusion is broken by many white pillars holding up what must be a distant cieling. In the center of this large room is a small plastic house.

>enter
You must supply a noun.

* * *

>examine house
You see a plastic house. You consider going inside. *hint: type "inside"

>insie
That's not a verb I recognise.

>inside
Play House
This house would be very cozy if it weren't sized for children. There is a kitchenette complete with a table, plastic stove and refrigerator, and a living room which contains a chair, a small throw rug, and a well-drawn picture of a television. There are many clocks drawn on the walls in crayon, each telling different times.

A little plastic stove that opens and closes.

A plastic refrigerator that opens and closes.

You can also see a table (on which is a plastic toaster) here.

>look house
You can't see any such thing.

>examine house
You can't see any such thing.

>examine house
You can't see any such thing.

>examine walls
You can't see any such thing.

>examine table
Yep, that's a table.

On the table is a plastic toaster.

>Examine television
You watch an imaginary news program on the imaginary television for a while before becoming bored and giving up.

* * *

>enter house
Play House
This house would be very cozy if it weren't sized for children. There is a kitchenette complete with a table, plastic stove and refrigerator, and a living room which contains a chair, a small throw rug, and a well-drawn picture of a television. There are many clocks drawn on the walls in crayon, each telling different times.

A little plastic stove that opens and closes.

A plastic refrigerator that opens and closes.

You can also see a table (on which is a plastic toaster) here.

You can go west to the Outside Room from here.

>enter
You must supply a noun.

>enter Play House
You can't see any such thing.

* * *

>enter house
Play House
This house would be very cozy if it weren't sized for children. There is a kitchenette complete with a table, plastic stove and refrigerator, and a living room which contains a chair, a small throw rug, and a well-drawn picture of a television. There are many clocks drawn on the walls in crayon, each telling different times.

A little plastic stove that opens and closes.

A plastic refrigerator that opens and closes.

You can also see a table (on which is a plastic toaster) here.

You can go west to the Outside Room from here.

>exit house
I only understood you as far as wanting to exit.

>go outside
You can't go that way.

* * *

>enter house
Play House
This house would be very cozy if it weren't sized for children. There is a kitchenette complete with a table, plastic stove and refrigerator, and a living room which contains a chair, a small throw rug, and a well-drawn picture of a television. There are many clocks drawn on the walls in crayon, each telling different times.

A little plastic stove that opens and closes.

A plastic refrigerator that opens and closes.

You can also see a table (on which is a plastic toaster) here.

You can go west to the Outside Room from here.

>enter stove
Play House
This house would be very cozy if it weren't sized for children. There is a kitchenette complete with a table, plastic stove and refrigerator, and a living room which contains a chair, a small throw rug, and a well-drawn picture of a television. There are many clocks drawn on the walls in crayon, each telling different times.

A little plastic stove that opens and closes.

A plastic refrigerator that opens and closes.

You can also see a table (on which is a plastic toaster) here.

You can go west to the Outside Room from here.

* * *

>go inside
Play House
This house would be very cozy if it weren't sized for children. There is a kitchenette complete with a table, plastic stove and refrigerator, and a living room which contains a chair, a small throw rug, and a well-drawn picture of a television. There are many clocks drawn on the walls in crayon, each telling different times.

A little plastic stove that opens and closes.

A plastic refrigerator that opens and closes.

You can also see a table (on which is a plastic toaster) here.

>outside
Outside Room
Opening the door reveals what at first looks to be a wide outdoor space filled with shrubs and grasses. A fog hangs in the air above you, obscuring the view upward. The illusion is broken by many white pillars holding up what must be a distant cieling. In the center of this large room is a small plastic house.

You see a plastic house. You consider going inside.

>take house
That's fixed in place.

>examine house
You see nothing special about the plastic house.

>enter house
That's not something you can enter.

* * *

>enter
You must supply a noun.

>enter house
That's not something you can enter.

>exit house
I only understood you as far as wanting to exit.

* * *

>enter house
That's not something you can enter.

>examine house
You see nothing special about the plastic house.

* * *

>examine door
It frightens you.

>s
You can't go that way.

* * *

>examine door
It frightens you.

>open door
It seems to be locked.

* * *

>open door
It seems to be locked.

>examine door
It frightens you.

* * *

>take key
Taken.

>examine key
It is a black key. It frightens you.

* * *

>take key
Taken.

>open gate with key
You unlock the metal gate.

>ne
(first opening the metal gate)

Utility Closet

* * *

>open darkness
You open the darkness, revealing a black key.

* * *

>take key
As you take the key, you are breifly overcome by a wave of vertigo. A knot forms in your stomach, and you have the terrible feeling that you have taken something which does not belong to you.

>examine key
It is a black key. It frightens you.

>examine darkness
You look into the darkness, and feel compelled to look away.

* * *

>take key
As you take the key, you are breifly overcome by a wave of vertigo. A knot forms in your stomach, and you have the terrible feeling that you have taken something which does not belong to you.

>examine darkness
You look into the darkness. It feels as if it could open up.

>open darkness
That's already open.

>close darkness
You close the darkness.

>examine key
It is a black key. It frightens you.

* * *

>examine clock
You try to read it, but you cannot make out the time. It doesn't matter though, because the clock is stopped, and the pendulum is not swinging.

In the grandfather clock is a pendulum.

>take clock
Taken.

* * *

>examine clock
You try to read it, but you cannot make out the time. It doesn't matter though, because the clock is stopped, and the pendulum is not swinging.

In the grandfather clock is a pendulum.

>open clock
You open the grandfather clock, revealing a pendulum.

* * *

>examine clock
You try to read it, but you cannot make out the time. It doesn't matter though, because the clock is stopped, and the pendulum is not swinging.

In the grandfather clock is a pendulum.

>w
You can't go that way.

>e
More Hallway
You are in a long hallway.  Identical doors are spaced regularly along the walls on either side. Many of the doors are closed and locked, but there are two doors to your immediate left and right (east and west) that are slightly ajar, and you can see two similar doors further down the hallway. The wall paper is a rich navy and powder-blue damask pattern. Combined with the dark wooden wainscotting, it gives the hallways an unnderving air of false comfort, with vauge suggestions of austerity.

You can go north, south, east and west to the Foyer from here.

>n
Even More Hallway
You are in a long hallway.  Identical doors are spaced regularly along the walls on either side. Many of the doors are closed and locked, but there are two doors to your immediate left and right (east and west) that are slightly ajar, and you can see two similar doors further down the hallway. The wall paper is a rich navy and powder-blue damask pattern. Combined with the dark wooden wainscotting, it gives the hallways an unnderving air of false comfort, with vauge suggestions of austerity. Near the east door, there is a spot on the wall where the wallpaper is peeling. You see a torn piece.

A neat section of the blue damask wall paper has torn, revealing a patch of yellow beneath it. You admire the torn piece.

You can go north, south to the More Hallway, east and west from here.

>e
Drinking Room
This room is fully furnished, with a white fainting couch, a grandfather clock, and a coffee table. All of the furniture is made of the same dark, rich wood that can be found throughout. On the wall there is a full-sized mirror and a large painting of a woman. In the northeast corner you can see a small metal gate stretched across a doorway. You think you can hear a faint ticking sound.

There is a fully stocked bar in the corner. It is has a beautiful curved countertop, and many shelves of liqours reach to the cieling behind it. Almost all of the bottles are brand new and sealed.

On the bar are a bottle of whiskey, a bottle of vodka, a bottle of gin and a lemon.

You can also see a metal gate and a grandfather clock (closed) here.

You can go northeast through the metal gate (closed) and west to the Even More Hallway from here.

>examine clock
You try to read it, but you cannot make out the time. It doesn't matter though, because the clock is stopped, and the pendulum is not swinging.

>take pendulum
You can't see any such thing.

* * *

>take clock
That's fixed in place.

>examine clock
A closer look reveals that it is not actually a clock, but a picture of a clock, firmly attached to the wall. You cannot read the time, because the clock has no hands.

* * *

>examine sofa
You can't see any such thing.

>take sofa
You can't see any such thing.

* * *

>take shoe
(the shoe rack)
That's fixed in place.

* * *

>take heels
Taken.

>take rack
That's fixed in place.

>take all
There are none at all available!

>examine heels
You see nothing special about the pair of women's heels.

* * *

>take heels
Taken.

>wear heels
You put on the pair of women's heels.

>wear shoes
You can't see any such thing.

>wear women's shoes
I only understood you as far as wanting to wear the pair of women's heels.

>wear women's heels
You can't wear that!

>wear heels
You can't wear that!

* * *

>examine rack
On the shoe rack is a pair of women's heels.

>take heels
Taken.

>examine heels
The heels are made with black, shiny pleather. The heel is a high stilletto. Looking at them makes you feel pretty, and a little embarrassed.

* * *

>examine mirror
Closer inspection reveals that it is not a mirror, but a picture of a mirror. You cannot see your reflection.

* * *

>examine painting
The woman is turned away. You cannot see her face.

* * *

>examine bar
You can't see any such thing.

* * *

>take bar
That's fixed in place.

>take whiskey
Taken.

>examine whiskey
You see nothing special about the bottle of whiskey.

* * *

>examine gin
You see nothing special about the bottle of gin.

>take gin
Taken.

>examine gin
You see nothing special about the bottle of gin.

* * *

>examine whiskey
You hate whiskey.

* * *

>examine gin
You like gin.

>examine vodka
You hate vodka.

>examine lemon
You see nothing special about the lemon.

* * *

>examine lemon
If you think about it for too long, you can taste it.

* * *

>open closet
You open the closet.

>examine closet
The closet is empty.

>examine bed
You can't see any such thing.

* * *

>examine closet
You see nothing special about the closet.

>open closet
It isn't something you can open.

* * *

>examine bed
You see nothing special about the bed.

* * *

>examine shoe rack
You can't see any such thing.

* * *

>examine heels
The heels are made with black, shiny pleather. The heel is a high stilletto. Looking at them makes you feel pretty and a little embarrassed.

>take heels
Taken.

* * *

>examine night light
The night light is currently switched off.

* * *

>take night light
Taken.

* * *

>take you
I don't suppose the you would care for that.

>drop you
Dropped.

>examine you
You see nothing special about the you.

* * *

>examine you
You are the only thing here.

>talk to you
That's not a verb I recognise.

>take you
I don't suppose the you would care for that.

* * *

>examine you
You are the only thing here.

>take secret
That seems to belong to you.

>examine secret
You see nothing special about your secret.

* * *

>talk to self
That's not a verb I recognise.

>take self
(the self)
I don't suppose the self would care for that.

* * *

>examine yourself
You can't see any such thing.

* * *

>examine nothing
You see nothing special about nothing.

* * *

>take nothing
You can't see any such thing.

>examine nothing
You see nothing special about nothing.

* * *

>take nothing
You can't see any such thing.

>take red key
Taken.

>examine key
You see nothing special about the nothing.

* * *

>take something
You grope around in the dark for a while, but cannot find it.

>examine something
You see nothing special about something.

>e
You can't go that way.

* * *

>w
Yet More Hallway
You are in a long hallway.  Identical doors are spaced regularly along the walls on either side. Each door has a sign beside it bearing a room number. There are two doors to your immediate left and right (east and west). The walls are papered. You can see the end of the hallway to the north.

>n
Hallway End
The hallway seems to end here. There are doors to the north, east, and west. There is something deeply disquieting about the doorway to the north, ordinary as it appears.

* * *

>w
You can't go that way.

>e
Outside Room
Opening the door reveals what at first looks to be a wide outdoor space filled with shrubs and grasses. A fog hangs in the air above you, obscuring the view upward. The illusion is broken by many white pillars holding up what must be a distant cieling. In the center of this large room is a small plastic house.

>enter house
You can't see any such thing.

>e
Play House
This house would be very cozy if it weren't sized for children. There is a kitchenette complete with a table, plastic stove and refrigerator, and a living room which contains a chair, a small throw rug, and a well-drawn picture of a television. There are many clocks drawn on the walls in crayon, each telling different times.

A little plastic stove that opens and closes.

A plastic refrigerator that opens and closes.

You can also see a table (on which is a plastic toaster) here.

* * *

>take something
You grope around in the dark for a while, but cannot find it.

>e
Something tells you  (put conditional here later)

* * *

>examine walls
The walls are unyielding.

>examine four
You can't see any such thing.

* * *

>examine walls
The walls are unyielding.

>take walls
That's fixed in place.

>pray
That's not a verb I recognise.

>escape
That's not a verb I recognise.

>god mode
That's not a verb I recognise.

>examine walls
The walls are unyielding.

* * *

>take walls
That's fixed in place.

>examine wallpaper
You can't see any such thing.

>examine wall paper
You can't see any such thing.

* * *

>examine walls
The walls are unyielding.

>listen
You hear nothing unexpected.

* * *

>take walls
That's fixed in place.

>examine walls
You see nothing special about the walls.

* * *

>examine figure
You see nothing special about the shadowy figure.

>talk to figure
That's not a verb I recognise.

>say hello to figure
There is no reply.

* * *

>examine secret
It's okay. No one knows your secret.

>ask you about secret
There is no reply.

* * *

>examine black door
It frightens you.

>w
More Hallway
You are in a long hallway.  Identical doors are spaced regularly along the walls on either side. Each door has a sign beside it bearing a room number. There are two doors to your immediate left and right (east and west). The walls are papered.

* * *

I beg your pardon?

>n
More Hallway
You are in a long hallway.  Identical doors are spaced regularly along the walls on either side. Many of the doors are closed and locked, but there are two doors to your immediate left and right (east and west) that are slightly ajar, and you can see two similar doors further down the hallway. The wall paper is a rich navy and powder-blue damask pattern. Combined with the dark wooden wainscotting, it gives the hallways an unnderving air of false comfort, with vauge suggestions of austerity.

You can go north, south to the Hallway, east and west from here.

>n
Even More Hallway
You are in a long hallway.  Identical doors are spaced regularly along the walls on either side. Many of the doors are closed and locked, but there are two doors to your immediate left and right (east and west) that are slightly ajar, and you can see two similar doors further down the hallway. The wall paper is a rich navy and powder-blue damask pattern. Combined with the dark wooden wainscotting, it gives the hallways an unnderving air of false comfort, with vauge suggestions of austerity. Near the east door, there is a spot on the wall where the wallpaper is peeling. You see a torn piece.

A neat section of the blue damask wall paper has torn, revealing a patch of yellow beneath it. You admire the torn piece.

You can go north, south to the More Hallway, east and west from here.

* * *

>north
More Hallway
You are in a long hallway.  Identical doors are spaced regularly along the walls on either side. Each door has a sign beside it bearing a room number. There are two doors to your immediate left and right (east and west). The walls are papered.

>examine walls
You can't see any such thing.

>j
That's not a verb I recognise.

>j
That's not a verb I recognise.

* * *

>north
More Hallway
You are in a long hallway.  Identical doors are spaced regularly along the walls on either side. Each door has a sign beside it bearing a room number. There are two doors to your immediate left and right (east and west). The walls are papered.

>north
Even More Hallway
You are in a long hallway.  Identical doors are spaced regularly along the walls on either side. Each door has a sign beside it bearing a room number. There are two doors to your immediate left and right (east and west). Near the east door, there is a spot on the wall where the wallpaper is peeling. You see a torn piece.

A neat section of the blue damask wall paper has torn, revealing a patch of yellow beneath it. You admire the torn piece briefly.

>east
Drinking Room
This room is fully furnished, with a blue fainting couch, a grandfather clock, and a coffee table. All of the furniture is made of the same dark, rich wood that can be found throughout. On the wall there is a full-sized mirror, and a large painting of a woman.

There is a grandfather clock here.

There is a fully stocked bar in the corner.

On the bar are a bottle of whiskey, a bottle of vodka, a bottle of gin and a lemon.

>examine bar
On the bar are a bottle of whiskey, a bottle of vodka, a bottle of gin and a lemon.

>examine gin
You like gin.

* * *

>examine toaster
Good for plastic toast, you imagine.

>open stove
You open the stove, revealing a plastic turkey.

* * *

>examine stove
You see nothing special about the stove.

>open stove
You open the stove, revealing a plastic turkey.

* * *

>examine turkey
Some things are exactly as they seem.

>e
You can't go that way.

>w
Outside Room
Opening the door reveals what at first looks to be a wide outdoor space filled with shrubs and grasses. A fog hangs in the air above you, obscuring the view upward. The illusion is broken by many white pillars holding up what must be a distant cieling. In the east corner of this large room is a small plastic house.

* * *

>n
You can't go that way.

>help
That's not a verb I recognise.

>w
Hallway End
The hallway seems to end here. There are doors to the north, east, and west. There is something deeply disquieting about the doorway to the north, ordinary as it appears.

>n
Hallway
You are in a long hallway.  Identical doors are spaced regularly along the walls on either side. Each door has a sign beside it bearing a room number. There are two doors to your immediate left and right (east and west). There a door to the south, and something about it is deeply disquieting, ordinary as it looks. The walls are papered. The air feels unnaturally still here.

* * *

>take meaning
That seems to belong to nothing.

* * *

>talk to something
That's not a verb I recognise.

>examine something
You see nothing special about something.

>take something
I don't suppose something would care for that.

* * *

>examine something
You see nothing special about something.

* * *

>take something
I don't suppose something would care for that.

>w
Yet More Hallway
You are in a long hallway.  Identical doors are spaced regularly along the walls on either side.  There are two doors to your immediate left and right (east and west). The walls are papered. You can see the end of the hallway to the north.

>s
Even More Hallway
You are in a long hallway.  Identical doors are spaced regularly along the walls on either side.  There are two doors to your immediate left and right (east and west). Near the east door, there is a spot on the wall where the wallpaper is peeling. You see a torn piece.

A neat section of the blue damask wall paper has torn, revealing a patch of yellow beneath it. You admire the torn piece briefly.

>s
More Hallway
You are in a long hallway.  Identical doors are spaced regularly along the walls on either side.  There are two doors to your immediate left and right (east and west). The walls are papered.

* * *

>w
Maze
The color of the wallpaper changes from blue to yellow around this corner, and the hallway diverges into many similar looking rooms with no furniture or ornamentation. You sense that if you keep going to the west, you may become lost.

>look
Maze
The color of the wallpaper changes from blue to yellow around this corner, and the hallway diverges into many similar looking rooms with no furniture or ornamentation. You sense that if you keep going to the west, you may become lost.

>s
You can't go that way.

>w
You can't go that way.

>e
Hallway End
The hallway seems to end here. There are doors to the north, east, and west. There is something deeply disquieting about the doorway to the north, ordinary as it appears.

>w
Maze
The color of the wallpaper changes from blue to yellow around this corner, and the hallway diverges into many similar looking rooms with no furniture or ornamentation. You sense that if you keep going to the west, you may become lost.

>w
You can't go that way.

* * *

>examine gate
It is a small moveable metal gate, similar to those you have seen guarding elevators in old buildings. It could be easily pushed aside except that it is currently padlocked shut. Behind it is a narrow blue door left slightly ajar. You can see a small room behind it; possibly a closet.

>open gate
It seems to be locked.

* * *

>ne
Old Mall
The hallway opens up into what appears to be an empty shopping mall. There is a high domed cieling with skylights overhead. The floor transitions from the carpeted hallway to over-large tan octagonal tiles. They air is cool here and slightly more humid, as if there were a water source nearby. You think you may even hear the distant trickle of water. A few small trees can be seen in planters, spaced decoratively. In contrast to the tense and silent hallway, This space is pleasant and serene. You can see the entrance to several shops. The Ordinary Shop is to the northeast, the Extraordinary Shop is to the northwest, and The Lonely and Dark stores are to the east and west respectively. There is also an escalator leading up to a second floor.

You can go north, south, southwest to the Darkness, east, west and up from here.

>open gate with key
You unlock the metal gate.

>ne
(first opening the metal gate)

Utility Closet
This is a small, cramped room full of dirty shelves and hardware. The main light source is a pair of florescent tubes which hum unpleasantly overhead. There are many odds and ends on the shelves: scraps of unused wall paper, cans of paste, rollers, an empty bottle of bleach, empty picture-frames, and two broken clocks. None of these seem to  be useful to you. There is also a yellowed, paint-stained sink, and in the east corner, an empty cardboard box so large that it blocks your view of the entire wall.

* * *

>e
Yet More Hallway
You are in a long hallway.  Identical doors are spaced regularly along the walls on either side.  Many of the doors are closed and locked, but there are two doors to your immediate left and right (east and west) that are slightly ajar, and you can see two similar doors further down the hallway. The wall paper is a rich navy and powder-blue damask pattern. Combined with the dark wooden wainscotting, it gives the hallway an unnderving air of false comfort, with vauge suggestions of austerity. You can see the end of the hallway to the north. 

You can go north, south and west to the Old Mall from here.

>e
You can't go that way.

* * *

>n
Hallway End
The hallway seems to end here. There are doors to the north, east, and west. There is something deeply disquieting about the doorway to the north, ordinary as it appears.

You can go north, south to the Yet More Hallway, east and west from here.

>s
Yet More Hallway
You are in a long hallway.  Identical doors are spaced regularly along the walls on either side.  Many of the doors are closed and locked, but there are two doors to your immediate left and right (east and west) that are slightly ajar, and you can see two similar doors further down the hallway. The wall paper is a rich navy and powder-blue damask pattern. Combined with the dark wooden wainscotting, it gives the hallway an unnderving air of false comfort, with vauge suggestions of austerity. You can see the end of the hallway to the north. 

You can go north to the Hallway End, south and west to the Old Mall from here.

>w
Old Mall
The hallway opens up into what appears to be an empty shopping mall. There is a high domed cieling with skylights overhead. The floor transitions from the carpeted hallway to over-large tan octagonal tiles. They air is cool here and slightly more humid, as if there were a water source nearby. You think you may even hear the distant trickle of water. A few small trees can be seen in planters, spaced decoratively. In contrast to the tense and silent hallway, This space is pleasant and serene. You can see the entrance to several shops. The Ordinary Shop is to the northeast, the Extraordinary Shop is to the northwest, and The Lonely and Dark stores are to the east and west respectively. There is also an escalator leading up to a second floor.

You can go north, south, southwest to the Darkness, east to the Yet More Hallway, west and up from here.

>se
You can't go that way.

>w
Extraordinary Room
This room is completely dark.

You can see something here.

You can go east to the Old Mall from here.

>e
Old Mall
The hallway opens up into what appears to be an empty shopping mall. There is a high domed cieling with skylights overhead. The floor transitions from the carpeted hallway to over-large tan octagonal tiles. They air is cool here and slightly more humid, as if there were a water source nearby. You think you may even hear the distant trickle of water. A few small trees can be seen in planters, spaced decoratively. In contrast to the tense and silent hallway, This space is pleasant and serene. You can see the entrance to several shops. The Ordinary Shop is to the northeast, the Extraordinary Shop is to the northwest, and The Lonely and Dark stores are to the east and west respectively. There is also an escalator leading up to a second floor.

You can go north, south, southwest to the Darkness, east to the Yet More Hallway, west to the Extraordinary Room and up from here.

>s
Lonely Room
This is a small room.

You can see a you here.

You can go north to the Old Mall from here.

* * *

>examine sign
WARNING: THIS IS NOT A PLACE.

* * *

>read sign
WARNING: THIS TANK WILL NOT EXIST.

* * *

>Examine sign
WARNING: THIS TANK DOES NOT EXIST.

* * *

>exits
That's not a verb I recognise.

>EXITS
That's not a verb I recognise.

>EXITS ON
That's not a verb I recognise.

>n
You can't go that way.

* * *

>s
You can't go that way.

>e
Hallway End
The hallway seems to end here. There are doors to the north, east, and west. There is something deeply disquieting about the doorway to the north, ordinary as it appears.

>w
Empty Corridor
You walk down a long section of empty hallway. Further west, you see that the hallway diverges into similar looking corridors with no doors, no furniture and no ornamentation. You sense that if you keep going to the west, you may become lost. The wallpaper is yellow here.

* * *

>examine machine
You see nothing special about the strange machine.

>turn on switch
Which do you mean, the red switch or the blue switch?

>use switch
You can't see any such thing.

>pull switch
Which do you mean, the red switch or the blue switch?

>blue
It is fixed in place.

* * *

>examine machine
You see nothing special about the strange machine.

>examine switch
The blue switch is currently switched off.

* * *

>examine aparatus
You can't see any such thing.

* * *

>turn on blue button
You can't see any such thing.

>press blue button
You can't see any such thing.

>examine button
The red button is currently switched off.

>press red button
It is fixed in place.

>switch red button
You switch the red button on.

* * *

>push button
You switch the button on.

* * *

>examine button
Which do you mean, the grey button or the red button?

>push button
You switch the machine on.

* * *

>examine button
Which do you mean, the grey button or the red button?

>grey
The grey button is currently switched off.

>press grey button
You switch the machine on.

>press red button
You hear a terrible whirring sound and feel a passing wave of nausia.

>w
You can't go that way.

>e
Indistinguishable Corridors
You are in an empty corridor like many others. The wallpaper is burgundy here.

These hallways are identical. You panic. You have lost your sense of direction.

* * *

>push red lever
You switch the red lever on.

* * *

>push blue button
nothing seems to have happened

* * *

>push blue button
You hear a terrible whirring sound, and feel a passing wave of nausia.

>push blue button
Nothing seems to have happened.

>e
Indistinguishable Corridors
You are in an empty corridor like many others. The wallpaper is powder-blue here.

These hallways are identical. You panic. You have lost your sense of direction.

* * *

>push lever
You switch the red lever on.

>push button
Which do you mean, the red button or the blue button?

>blue
It is fixed in place.

>red
That's not a verb I recognise.

>push red button
You switch the machine on.

* * *

>push red button
You switch the machine on.

>push red button
You switch the machine off.

* * *

>press blue button
You can't see any such thing.

>s
You can't go that way.

>e
Indistinguishable Corridors
You are in an empty corridor like many others. The wallpaper is yellow here.

These hallways are identical. You panic. You have lost your sense of direction.

* * *

>w
Indistinguishable Corridors
You are in an empty corridor like many others. The wallpaper is yellow here.

These hallways are identical. You panic. You have lost your sense of direction.

>n
You can't go that way.

* * *

>press the blue button
It is fixed in place.

>press the red button
You switch the machine on.

>look
Machine Room
There is a blue button, a red button, and a red lever on the machine.

You can go east from here.

>e
Indistinguishable Corridors
You are in an empty corridor like many others. The wallpaper is orange here.

These hallways are identical. You panic. You have lost your sense of direction.

* * *

>push the blue button
nothing seems to have happened

>push the red button
You switch the machine on.

>push the blue button
You hear a terrible whirring sound, and feel a passing wave of nausia.

>w
You can't go that way.

>e
Indistinguishable Corridors
You are in an empty corridor like many others. The wallpaper is orange here.

These hallways are identical. You panic. You have lost your sense of direction.

* * *

>open tack-barrier
the tacks are too sharp for you to cross barefoot.

>open
What do you want to open?

>n
You must name something more substantial.

>w
You can't go that way.

* * *

>open glass
It isn't something you can open.

* * *

>sw
You can't go that way.

* * *

>se
Foyer
Despite being an isolated room in the middle of a hallway, this room appears to be a foyer. There is a small sofa and a shoe rack along the west wall. On the north wall, there is a clock. There is a staircase in the northwest corner leading down. The bottom of the stairs is in darkness, but you think you percieve the vague outline of a person there.

You can see a shoe rack (on which is a pair of women's heels) here.

You can go northwest to the Stair Landing and east from here.

>w
Utility Closet
This is a cramped, narrow room full of dirty shelves and hardware. The main light source is a pair of florescent tubes which hum unpleasantly overhead. This is augmented by the sqeaking of your feet on the linoleum tiles below. There are many odds and ends on the shelves: scraps of unused wall paper, cans of paste, rollers, an empty bottle of bleach, picture-frames, and two broken clocks. None of these seem to  be useful to you. There is also a yellowed, paint-stained sink.

You can see a metal gate here.

You can go southwest through the metal gate (closed) and east to the Corner from here.

>se
You can't go that way.

* * *

>se
Foyer
Despite being an isolated room in the middle of a hallway, this room appears to be a foyer. There is a small sofa and a shoe rack along the west wall. On the north wall, there is a clock. There is a staircase in the northwest corner leading down. The bottom of the stairs is in darkness, but you think you percieve the vague outline of a person there.

You can see a shoe rack (on which is a pair of women's heels) here.

You can go northwest to the Stair Landing and east from here.

>e
Hallway
This is a long hallway that seems to stretch endlessly in either direction.  It is reminiscent of the halls that one might see in a fancy hotel; identical doors are spaced regularly along the walls on either side, each of which are outfitted with a black box above the handle designed to accept a key card. The walls are papered with a rich navy and powder-blue damask pattern, and a tightly knitted carpet frames the passage, tracing muted grey and gold stripes down its length.  The air feels unnaturally still here.

You can go north, south, east and west to the Foyer from here.

>w
Foyer
Despite being an isolated room in the middle of a hallway, this room appears to be a foyer. There is a small sofa and a shoe rack along the west wall. On the north wall, there is a clock. There is a staircase in the northwest corner leading down. The bottom of the stairs is in darkness, but you think you percieve the vague outline of a person there.

You can see a shoe rack (on which is a pair of women's heels) here.

You can go northwest to the Stair Landing and east to the Hallway from here.

>e
Hallway
This is a long hallway that seems to stretch endlessly in either direction.  It is reminiscent of the halls that one might see in a fancy hotel; identical doors are spaced regularly along the walls on either side, each of which are outfitted with a black box above the handle designed to accept a key card. The walls are papered with a rich navy and powder-blue damask pattern, and a tightly knitted carpet frames the passage, tracing muted grey and gold stripes down its length.  The air feels unnaturally still here.

You can go north, south, east and west to the Foyer from here.

>s
You walk some distance down the length of the hallway until you arrive at the next set of adjacent doors

Hallway
This is a long hallway that seems to stretch endlessly in either direction.  It is reminiscent of the halls that one might see in a fancy hotel; identical doors are spaced regularly along the walls on either side, each of which are outfitted with a black box above the handle designed to accept a key card. The walls are papered with a rich navy and powder-blue damask pattern, and a tightly knitted carpet frames the passage, tracing muted grey and gold stripes down its length.  The air feels unnaturally still here.

You can go north to the Hallway, south, east and west from here.

>s
You walk some distance down the length of the hallway until you arrive at the next set of adjacent doors
Hallway
You are standing in the middle a long hallway that seems to stretch endlessly in either direction.  It is reminiscent of the halls that one might see in a fancy hotel; identical doors are spaced regularly along the walls on either side, each of which are outfitted with a black box above the handle designed to accept a key card. The walls are papered with a rich navy and powder-blue damask pattern, and a tightly knitted carpet frames the passage, tracing muted grey and gold stripes down its length.  The air feels unnaturally still here.

You can go north to the Hallway, south, east and west from here.

* * *

>n
You walk some distance down the length of the hallway until you arrive at the next set of adjacent doors

Hallway
This is a long hallway that seems to stretch endlessly in either direction.  It is reminiscent of the halls that one might see in a fancy hotel; identical doors are spaced regularly along the walls on either side, each of which are outfitted with a black box above the handle designed to accept a key card. The walls are papered with a rich navy and powder-blue damask pattern, and a tightly knitted carpet frames the passage, tracing muted grey and gold stripes down its length.  The air feels unnaturally still here.

You can go north, south to the Hallway, east and west to the Foyer from here.

>n
You walk some distance down the length of the hallway until you arrive at the next set of adjacent doors

Hallway
You are standing in the middle a long hallway that seems to stretch endlessly in either direction.  It is reminiscent of the halls that one might see in a fancy hotel; identical doors are spaced regularly along the walls on either side, each of which are outfitted with a black box above the handle designed to accept a key card. The walls are papered with a rich navy and powder-blue damask pattern, and a tightly knitted carpet frames the passage, tracing muted grey and gold stripes down its length.  The air feels unnaturally still here.

A steel knife is embedded in the wall nearby.

A neat section of the blue damask wall paper has torn, revealing a patch of yellow beneath it. You admire the torn piece.

You can go north, south to the Hallway, east and west from here.

* * *

>open gate with key
You unlock the metal gate.

>ne
(first opening the metal gate)

Utility Closet
This is a cramped, narrow room full of dirty shelves and hardware. The main light source is a pair of florescent tubes which hum unpleasantly overhead. This is augmented by the sqeaking of your feet on the linoleum tiles below. There are many odds and ends on the shelves: scraps of unused wall paper, cans of paste, rollers, an empty bottle of bleach, picture-frames, and two broken clocks. None of these seem to  be useful to you. There is also a yellowed, paint-stained sink.

You can see a metal gate here.

You can go southwest through the metal gate to the Drinking Room and east from here.

>put on heels
You put on the pair of women's heels.

>n
You can't go that way.

>e
Corner
You wade through the debris and shimmy yourself into the narrow east corner of the utility closet, where it is even dirtier. You notice that the floor is damp here and the linoleum warped. There must have been a disturbance recently, because a cracked can of paste has permanently glued a pile of shattered glass to the floor on the north side of the passage. Behind it is a dingy crawlspace door.

You can see some broken glass here.

You can go west to the Utility Closet. The path to the north is blocked by the broken glass.

>w
Utility Closet
This is a cramped, narrow room full of dirty shelves and hardware. The main light source is a pair of florescent tubes which hum unpleasantly overhead. This is augmented by the sqeaking of your feet on the linoleum tiles below. There are many odds and ends on the shelves: scraps of unused wall paper, cans of paste, rollers, an empty bottle of bleach, picture-frames, and two broken clocks. None of these seem to  be useful to you. There is also a yellowed, paint-stained sink.

You can see a metal gate here.

You can go southwest through the metal gate to the Drinking Room and east to the Corner from here.

>w
You can't go that way.

* * *

>e
Corner
You wade through the debris and shimmy yourself into the narrow east corner of the utility closet, where it is even dirtier. You notice that the floor is damp here and the linoleum warped. There must have been a disturbance recently, because a cracked can of paste has permanently glued a pile of shattered glass to the floor on the north side of the passage. Behind it is a dingy crawlspace door.

You can see some broken glass here.

You can go west to the Utility Closet. The path to the north is blocked by the broken glass.

>n
The high-heels protect your feet as you gingerly step over the broken glass.

>look
Corner
You wade through the debris and shimmy yourself into the narrow east corner of the utility closet, where it is even dirtier. You notice that the floor is damp here and the linoleum warped. There must have been a disturbance recently, because a cracked can of paste has permanently glued a pile of shattered glass to the floor on the north side of the passage. Behind it is a dingy crawlspace door.

You can see some broken glass here.

You can go west to the Utility Closet. The path to the north is blocked by the broken glass.

* * *

>e
Corner
You wade through the debris and shimmy yourself into the narrow east corner of the utility closet, where it is even dirtier. You notice that the floor is damp here and the linoleum warped. There must have been a disturbance recently, because a cracked can of paste has permanently glued a pile of shattered glass to the floor on the north side of the passage. Behind it is a dingy crawlspace door.

You can see some broken glass here.

You can go west to the Utility Closet. The path to the north is blocked by the broken glass.

* * *

>open gate with key
You unlock the metal gate.

>go through gate
(first opening the metal gate)

Utility Closet
This is a cramped, narrow room full of dirty shelves and hardware. The main light source is a pair of florescent tubes which hum unpleasantly overhead. This is augmented by the sqeaking of your feet on the linoleum tiles below. There are many odds and ends on the shelves: scraps of unused wall paper, cans of paste, rollers, an empty bottle of bleach, picture-frames, and two broken clocks. None of these seem to  be useful to you. There is also a yellowed, paint-stained sink.

You can see a metal gate here.

You can go southwest through the metal gate to the Drinking Room and east from here.

>e
Corner
You wade through the debris and shimmy yourself into the narrow east corner of the utility closet, where it is even dirtier. You notice that the floor is damp here and the linoleum warped. There must have been a disturbance recently, because a cracked can of paste has permanently glued a pile of shattered glass to the floor on the north side of the passage. Behind it is a dingy crawlspace door.

You can see some broken glass here.

You can go west to the Utility Closet. The path to the north is blocked by the broken glass.

* * *

>put on heels
You put on the pair of women's heels.

>n
The high-heels protect your feet as you gingerly step over the broken glass.

That's not something you can enter.

* * *

>open gate
It seems to be locked.

>open gate with key
You unlock the metal gate.

* * *

>put on heels
You put on the pair of women's heels.

>n
The high-heels protect your feet as you gingerly step over the broken glass.

Tanks
You step through the crawlspace door, and are surprised to find that the passage opens up to a room that is much plainer and easier to navigate. Here, there are five metal tanks that come up to about shoalder height. They are evenly distributed against a red brick wall. Above each tank is a pipe leading to a valve, as if to fill it. Below each tank is a second valve, and pipes that lead into the floor below.

There is a sign above the fifth tank.

You can also see some broken glass here.

You can go south through the broken glass (closed) to the Corner from here.

* * *

>open gate with key
You unlock the metal gate.

>n
You can't go that way.

>go through gate
(first opening the metal gate)

Utility Closet
This is a cramped, narrow room full of dirty shelves and hardware. The main light source is a pair of florescent tubes which hum unpleasantly overhead. This is augmented by the sqeaking of your feet on the linoleum tiles below. There are many odds and ends on the shelves: scraps of unused wall paper, cans of paste, rollers, an empty bottle of bleach, picture-frames, and two broken clocks. None of these seem to  be useful to you. There is also a yellowed, paint-stained sink.

You can see a metal gate here.

You can go southwest through the metal gate to the Drinking Room and east from here.

* * *

>put on heels
You put on the pair of women's heels.

>take off shoes
You can't see any such thing.

>n
The high-heels protect your feet as you gingerly step over the broken glass.

Tanks
You step through the crawlspace door, and are surprised to find that the passage opens up to a room that is much plainer and easier to navigate. Here, there are five metal tanks that come up to about shoalder height. They are evenly distributed against a red brick wall. Above each tank is a pipe leading to a valve, as if to fill it. Below each tank is a second valve, and pipes that lead into the floor below.

There is a sign above the fifth tank.

You can also see some broken glass here.

The path to the south is blocked by the broken glass.

>read sign
WARNING: THIS TANK WILL NOT EXIST.

* * *

>talk to figure
That's not a verb I recognise.

>talk to shadowy figure
That's not a verb I recognise.

>speak to shadowy figure
I didn't understand that sentence.

>say "hi" to shadowy figure
There is no reply.

* * *

>say hello to shadowy figure
There is no reply.

* * *

>say hi to shadowy figure
There is no reply.

* * *

>down
There is something terrible about the stairs that chills your blood. As you take your first step down, you are overcome with waves of fear and weakness. Unnameable images flash through your mind. You gasp for breath, but there is no air. Darkness consumes you as your body falls limp into the void.

 You are standing on a slab of concrete that is four foot square. Around you on every side are grey brick walls that stretch upward indefinitely. Your fear resolves into a grim sense of familiarity, and a heavy burden lifts from your shoulders. You feel oddly at peace.

You can see the walls here.

You can see no obvious exits.

* * *

>examine stairway
The stairway is inexplicibly horrifying to you; it conjures up thoughts too terrible to acknowledge and twisted memories of unnameable deeds. Looking at them makes you feel ill, but you are drawn to them. You know that you must follow them down.

* * *

>examine staircase
The stairway is inexplicibly horrifying to you; it conjures up thoughts too terrible to acknowledge and twisted memories of unnameable deeds.

>down
There is something terrible about the stairs that chills you to the core. As you take your first step down, you are overcome with waves of fear and weakness. Unnameable images flash through your mind. You gasp for breath, but there is no air. Darkness consumes you as your body falls limp into the void.

Walls 
You are standing on a slab of concrete that is four foot square. Around you on every side are grey brick walls that stretch upward indefinitely. Your fear resolves into a grim sense of familiarity, and a heavy burden lifts from your shoulders. You feel oddly at peace.

You can see the walls here.

You can see no obvious exits.

* * *

>examine staircase
The stairway is inexplicibly horrifying to you; it conjures up thoughts too terrible to acknowledge and twisted memories of unnameable deeds.

>take staircase
That's fixed in place.

>d
These stairs frighten you. You can feel the tension increasing. You are now you are extremely tense.
.

>d
The terrible feeling that the stairs give you pushes you over the edge. You are completely overwhelmed by the terrible feeling in the back of your mind, and you succumb to it. 
 ... 

Walls (in the walls)
You are standing on a slab of concrete that is four foot square. Around you on every side are grey brick walls that stretch upward indefinitely. Your fear resolves into a grim sense of familiarity, and a heavy burden lifts from your shoulders. You feel oddly at peace.

You can see no obvious exits.

* * *

>dring gin
That's not a verb I recognise.

>drink gin
There's nothing suitable to drink here.

>take gin
You already have that.

>i
You are carrying:
  a bottle of gin

>drink bottle of gin
There's nothing suitable to drink here.

* * *

>thank darkness
That's not a verb I recognise.

* * *

>examine cabinet
It is a small unassuming cabinet made of white wood. In spite of its plainness, it exhudes a strange, foreboding aura.

>open cabinet
As you reach for the cabinet, you realize that you cannot touch it. Your hand falls to your side.

>s
You can't go that way.

>e
Even More Hallway
You are in a long hallway.  Identical doors are spaced regularly along the walls on either side. Many of the doors are closed and locked, but there are two doors to your immediate left and right (east and west) that are slightly ajar, and you can see two similar doors further down the hallway. The wall paper is a rich navy and powder-blue damask pattern. Combined with the dark wooden wainscotting, it gives the hallways an unnderving air of false comfort, with vauge suggestions of austerity. Near the east door, there is a spot on the wall where the wallpaper is peeling. You see a torn piece.

A neat section of the blue damask wall paper has torn, revealing a patch of yellow beneath it. You admire the torn piece.

You can go north, south, east and west to the Bedroom from here.

>e
Drinking Room
This room is fully furnished including a white fainting couch, a grandfather clock, and a coffee table. All of the furniture is made of the same dark, rich wood that can be found throughout. On the wall there is a full-sized mirror and a large painting of a woman. In the northeast corner you can see a small metal gate stretched across a doorway. You think you can hear a faint ticking sound.

There is a fully stocked bar in the corner. It is has a beautiful curved countertop and many shelves of liqours which reach to the cieling behind it. Almost all of the bottles are brand new and sealed.

On the bar are a bottle of whiskey, a bottle of vodka, a bottle of gin and a lemon.

You can see a grandfather clock here.

You can also see a metal gate here.

You can go northeast through the metal gate (closed) and west to the Even More Hallway from here.

>open gate
It seems to be locked.

>take all
bottle of whiskey: Taken.
bottle of vodka: Taken.
bottle of gin: Taken.
lemon: Taken.

>look
Drinking Room
This room is fully furnished including a white fainting couch, a grandfather clock, and a coffee table. All of the furniture is made of the same dark, rich wood that can be found throughout. On the wall there is a full-sized mirror and a large painting of a woman. In the northeast corner you can see a small metal gate stretched across a doorway. You think you can hear a faint ticking sound.

There is a fully stocked bar in the corner. It is has a beautiful curved countertop and many shelves of liqours which reach to the cieling behind it. Almost all of the bottles are brand new and sealed.

You can see a grandfather clock here.

You can also see a metal gate here.

You can go northeast through the metal gate (closed) and west to the Even More Hallway from here.

>open clock
You open the grandfather clock, revealing a pendulum.

* * *

>examine pendulum
It is strangely familiar to you.

>w
Even More Hallway
You are in a long hallway.  Identical doors are spaced regularly along the walls on either side. Many of the doors are closed and locked, but there are two doors to your immediate left and right (east and west) that are slightly ajar, and you can see two similar doors further down the hallway. The wall paper is a rich navy and powder-blue damask pattern. Combined with the dark wooden wainscotting, it gives the hallways an unnderving air of false comfort, with vauge suggestions of austerity. Near the east door, there is a spot on the wall where the wallpaper is peeling. You see a torn piece.

A neat section of the blue damask wall paper has torn, revealing a patch of yellow beneath it. You admire the torn piece.

You can go north, south, east to the Drinking Room and west to the Bedroom from here.

>w
Bedroom
This looks like a bedroom. There is a bed, a wardrobe, and a mirror. There is also a small night light plugged into an outlet in the wall.

 The night light is off.

You can also see a wardrobe (closed) and a cabinet (closed) here.

You can go east to the Even More Hallway from here.

>e
Even More Hallway
You are in a long hallway.  Identical doors are spaced regularly along the walls on either side. Many of the doors are closed and locked, but there are two doors to your immediate left and right (east and west) that are slightly ajar, and you can see two similar doors further down the hallway. The wall paper is a rich navy and powder-blue damask pattern. Combined with the dark wooden wainscotting, it gives the hallways an unnderving air of false comfort, with vauge suggestions of austerity. Near the east door, there is a spot on the wall where the wallpaper is peeling. You see a torn piece.

A neat section of the blue damask wall paper has torn, revealing a patch of yellow beneath it. You admire the torn piece.

You can go north, south, east to the Drinking Room and west to the Bedroom from here.

* * *

>e
You can't go that way.

>w
Old Mall
The hallway opens up into what appears to be an empty shopping mall. There is a high domed cieling with skylights overhead. The floor transitions from the carpeted hallway to over-large tan octagonal tiles. They air is cool here and slightly more humid, as if there were a water source nearby. You think you may even hear the distant trickle of water. A few small trees can be seen in planters, spaced decoratively. In contrast to the tense and silent hallway, This space is pleasant and serene. You can see the entrance to several shops. The Ordinary Shop is to the northeast, the Extraordinary Shop is to the northwest, and The Lonely and Dark stores are to the east and west respectively. There is also an escalator leading up to a second floor.

You can go north, south, southwest, east to the Yet More Hallway, west and up from here.

* * *

>w
Indistinguishable Corridors
You are in an empty corridor like many others. The wallpaper is yellow here.

These hallways are identical. You panic. You have lost your sense of direction.

>e
Empty Corridor
This is a long section of empty hallway. Further west, you see that the hallway diverges into similar looking corridors with no doors, no furniture and no ornamentation. You sense that if you keep going to the west, you may become lost. The wallpaper is yellow here.

You can go east to the Hallway End and west to Indistinguishable Corridors from here.

>e
Hallway End
The hallway seems to end here. There are doors to the north, east, and west. There is something deeply disquieting about the doorway to the north, ordinary as it appears.

You can go north, south to the Yet More Hallway, east and west to the Empty Corridor from here.

* * *

>e
Outside Room
Opening the door reveals what at first looks to be a wide outdoor space filled with shrubs and grasses. A fog hangs in the air above you, obscuring the view upward. The illusion is broken by many white pillars holding up what must be a distant cieling. In the east corner of this large room is a small plastic house.

You can go east and west to the Hallway End from here.

>enter house
You can't see any such thing.

* * *

>open cabinet
As you reach for the cabinet, you realize that you cannot touch it. Your hand falls to your side.

* * *

>enter play house
You can't see any such thing.

>enter house
You can't see any such thing.

* * *

>exit
But you aren't in anything at the moment.

>enter
You must supply a noun.

>enter house
Play House
This house would be very cozy if it weren't sized for children. There is a kitchenette complete with a table, plastic stove and refrigerator, and a living room which contains a chair, a small throw rug, and a well-drawn picture of a television. There are many clocks drawn on the walls in crayon, each telling different times.

A little plastic stove that opens and closes.

A plastic refrigerator that opens and closes.

You can also see a table (on which is a plastic toaster) here.

You can go west to the Outside Room from here.

>w
Outside Room
Opening the door reveals what at first looks to be a wide outdoor space filled with shrubs and grasses. A fog hangs in the air above you, obscuring the view upward. The illusion is broken by many white pillars holding up what must be a distant cieling. In the east corner of this large room is a small plastic house.

You can go east to the Play House and west from here.

>enter
You must supply a noun.

* * *

>enter house
Play House
This house would be very cozy if it weren't sized for children. There is a kitchenette complete with a table, plastic stove and refrigerator, and a living room which contains a chair, a small throw rug, and a well-drawn picture of a television. There are many clocks drawn on the walls in crayon, each telling different times.

A little plastic stove that opens and closes.

A plastic refrigerator that opens and closes.

You can also see a table (on which is a plastic toaster) here.

You can go west to the Outside Room from here.

>examine clocks
Many clocks of different colors are drawn on the walls in crayon. They each tell different times, but strangely, you have trouble reading any of them.

* * *

>put on heels
You climb into the patent leather heels and strap them to your feet. They shine pleasantly. You feel pretty, and a little embarrased.

>n
The high-heels protect your feet as you gingerly step over the broken glass.

Tanks
You step through the crawlspace door, and are surprised to find that the passage opens up to a room that is much plainer and easier to navigate. Here, there are five metal tanks that come up to about shoulder height. They are evenly distributed against a red brick wall. Above each tank is a pipe leading to a valve, as if to fill it. Below each tank is a second valve and pipes that lead into the floor below.

There is a sign above the fifth tank.

You can also see some broken glass here.

The path to the south is blocked by the broken glass.

* * *

>m
That's not a verb I recognise.

* * *

>thank you
As you thank yourself, you experience a warm feeling of satisfaction. You have been working so hard to manage things in spite of these stressful circumstances, and to hear yourself validate those efforts fills you with peace. You are so grateful for this act of kindness that you decide to share your secret with yourself at last, after a lifetime of keeping it tucked away in the back of your mind. Your relief is immesurable.

>drop secret
Your secret is precious to you. You would rather not leave it laying around for anyone to find.

>examine secret
It's alright. No one knows your secret.

* * *

>thank you
As you thank yourself, you experience a warm feeling of satisfaction. You have been working so hard to manage things in spite of these stressful circumstances, and to hear yourself validate those efforts fills you with peace. You are so grateful for this act of kindness that you decide to share your secret with yourself at last, after a lifetime of keeping it tucked away in the back of your mind. Your relief is immesurable.

>take secret
You already have that.

>drop secret
Your secret is precious to you. You would rather not leave it laying around for anyone to find.

>examine secret
Don't worry. No one knows your secret.

* * *

>i
You are carrying:
  a cookie
  a booze
  a solutions manual

>take secret
That seems to belong to you.

>examine you
You are the only thing here.

>thank you
You are welcome.

>i
You are carrying:
  your secret
  a pair of women's heels

* * *

>i
You are carrying:
  a cookie
  a booze
  a solutions manual

>thank you
As you thank yourself, you feel a warm sensation of satisfaction. You have been working so hard to manage things well in spite of these strange and stressful circumstances; so to hear yourself validate your own success fills you with peace. You are so greatful for this act of kindness that you decide to share your secret with yourself at last, after a lifetime of keeping it tucked away in the back of your mind. Your relief is immesurable.

>i
You are carrying:
  your secret
  a pair of women's heels

>examine secret
It's alright. No one knows your secret.

* * *

>i
You are carrying:
  a cookie
  a booze
  a solutions manual

>read manual
You flip the pages randomly and arrive at page 2:

It says: "Thank You."

>read manual
You flip the pages randomly and arrive at page 5:

It says: "Another Hint"

>read manual
You flip the pages randomly and arrive at page 2:

It says: "Thank You."

>read page 5
(in the solutions manual)
It says: "Another Hint"

>read page 1
(in the solutions manual)
It says: "The darkness opens up."

>read page 2
(in the solutions manual)
It says: "Thank You."

>examine manual
You see nothing special about the solutions manual.

* * *

>i
You are carrying:
  a cookie
  a booze
  a solutions manual

>drink booze
You down it in one gulp. It relaxes you. You can feel the tension in the back of your mind decreasing.
The liquid warms your stomach, and the world softens. How wonderful. You feel less tense than you did a moment ago. Now you are you are completely relaxed.

>i
You are carrying:
  a cookie
  a solutions manual

* * *

>Thank you
As you thank yourself, you feel a warm sensation of satisfaction. You have been working so hard to manage things well in spite of these stressful circumstances; so to hear yourself validating those efforts fills you with peace. You are so greatful for this act of kindness that you decide to share your secret with yourself at last, after a lifetime of keeping it tucked away in the back of your mind. Your relief is immesurable.

* * *

>thank wall
You can't see any such thing.

>thank you
As you thank yourself, you experience a warm feeling of satisfaction. You have been working so hard to manage things well in spite of these stressful circumstances, and to hear yourself validate those efforts fills you with peace. You are so greatful for this act of kindness that you decide to share your secret with yourself at last, after a lifetime of keeping it tucked away in the back of your mind. Your relief is immesurable.

>thank secret
There is no response.

* * *

>l
You are in the main hallway. It stretches indefinitely in either direction. There are doors to your east and west.
The obvious exits are north, south, east and west.

>s
...you walk some distance down the length of the hallway until you arrive at the next set of adjacent doors...

Hallway
You are standing in the middle a long hallway that seems to stretch endlessly in either direction.  It is reminiscent of the halls that one might see in a fancy hotel; identical doors are spaced regularly along the walls on either side, each of which are outfitted with a black box above the handle designed to accept a key card. The walls are papered with a rich navy and powder-blue damask pattern, and a tightly knitted carpet frames the passage, tracing muted grey and gold stripes down its length.  The air feels unnaturally still here.

You can go north, south, east and west from here.

>n
...you walk some distance down the length of the hallway until you arrive at the next set of adjacent doors...

Hallway
This is a long hallway that seems to stretch endlessly in either direction.  It is reminiscent of the halls of a fancy hotel; identical doors are spaced regularly along the walls on either side, each of which are outfitted with a black box above the handle designed to accept a key card. The walls are papered with a rich navy and powder-blue damask pattern, and a tightly knitted carpet frames the passage, tracing muted grey and gold stripes down its length. The air feels unnaturally still 

You can go north, south to the Hallway, east and west from here.

>l
You are in the main hallway. It stretches indefinitely in either direction. There are doors to your east and west.
The obvious exits are north, south (to the hallway), east and west.

* * *

>take wall apper
I only understood you as far as wanting to take the wall paper.

>take wall paper
That's hardly portable.

* * *

>take paper
Taking the torn piece between two fingers, you pull gently, and a section of paper is smoothly stripped away. Yellow wall paper is revealed behind it, printed with an identical damask pattern in white. This paper however is blemished by the presence of a now-visible crack in the drywall that branches in every direction, meeting at a point beneath the spot where the paper was lifted. You can see something inside.

Taken.

>take knife
Taken.

>cut crack with knife
I only understood you as far as wanting to cut the crack.

* * *

>take paper
Taking the torn piece between two fingers, you pull gently, and a section of paper is smoothly stripped away. Yellow wall paper is revealed behind it, printed with an identical damask pattern in white. This paper however is blemished by the presence of a now-visible crack in the drywall that branches in every direction, meeting at a point beneath the spot where the paper was lifted. You can see something inside.

Taken.

>i
You are carrying:
  a torn piece

* * *

>give up
When you decide to give up, nothing can stop you.

    *** YOU HAVE GIVEN UP ***

Would you like to RESTART, RESTORE a saved game, QUIT or UNDO the last command?

>i
You are carrying:
  a meaning
  a solutions manual

* * *

>give up
When you decide to give up, nothing can stop you.

    *** YOU HAVE GIVEN UP ***

Would you like to RESTART, RESTORE a saved game, QUIT or UNDO the last command?

>undo
Bedroom
[Previous turn undone.]

>e
Hallway
You are standing in the middle a long hallway that seems to stretch endlessly in either direction.  It is reminiscent of the halls that one might see in a fancy hotel; identical doors are spaced regularly along the walls on either side, each of which are outfitted with a black box above the handle designed to accept a key card. The walls are papered with a rich navy and powder-blue damask pattern, and a tightly knitted carpet frames the passage, tracing muted grey and gold stripes down its length.  The air feels unnaturally still here.

A neat section of the blue damask wall paper has torn, revealing a patch of yellow beneath it. You admire the torn piece.

You can also see a steel knife here.

You can go north, south, east and west to the Bedroom from here.

>e
Drinking Room
This room is fully furnished including a white fainting couch, a grandfather clock, and a coffee table. All of the furniture is made of the same dark, rich wood that can be found throughout. On the wall there is a full-sized mirror and a large painting of a woman. In the northeast corner you can see a small metal gate stretched across a doorway. You think you can hear a faint ticking sound.

There is a fully stocked bar in the corner. It is has a beautiful curved countertop and many shelves of liqours which reach to the cieling behind it. Almost all of the bottles are brand new and sealed.

On the bar are a bottle of whiskey, a bottle of vodka, a bottle of gin and a lemon.

You can see a grandfather clock here.

You can also see a metal gate here.

You can go northeast through the metal gate (closed) and west to the Hallway from here.

>ne
(first opening the metal gate)
It seems to be locked.

>open gate
It seems to be locked.

>i
You are carrying:
  a solutions manual

>read manual
You flip the pages randomly and arrive at page 5:

It says: "hint."

>read manual
You flip the pages randomly and arrive at page 5:

It says: "hint."

>read manual
You flip the pages randomly and arrive at page 2:

It says: "THANK YOU."

>read manual
You flip the pages randomly and arrive at page 5:

It says: "hint."

>read manual
You flip the pages randomly and arrive at page 3:

It says: "NOTHING HAS MEANING. LET NOTHING STOP YOU FROM GIVING UP."

>read manual
You flip the pages randomly and arrive at page 5:

It says: "hint."

>read page 4
(in the solutions manual)
It says: "SOMETHING IS WRONG."

>look behind box
You can't see any such thing.

>look behind manual
You can't see any such thing.

>look behind nightstand
You can't see any such thing.

>move nightstand
You can't see any such thing.

>look
Drinking Room
This room is fully furnished including a white fainting couch, a grandfather clock, and a coffee table. All of the furniture is made of the same dark, rich wood that can be found throughout. On the wall there is a full-sized mirror and a large painting of a woman. In the northeast corner you can see a small metal gate stretched across a doorway. You think you can hear a faint ticking sound.

There is a fully stocked bar in the corner. It is has a beautiful curved countertop and many shelves of liqours which reach to the cieling behind it. Almost all of the bottles are brand new and sealed.

On the bar are a bottle of whiskey, a bottle of vodka, a bottle of gin and a lemon.

You can see a grandfather clock here.

You can also see a metal gate here.

You can go northeast through the metal gate (closed) and west to the Hallway from here.

>look behind clock
You can't see any such thing.

>look behind bar
You can't see any such thing.

>look bar
On the bar are a bottle of whiskey, a bottle of vodka, a bottle of gin and a lemon.

>move bar
It is fixed in place.

>move lemon
Nothing obvious happens.

* * *

>read manual
You flip the pages randomly and arrive at page 6:

It says: "THE WORLD."

>read page 3 in manual
It says: "Nothing has meaning. If you want to give up, let nothing stop you."

>w
You can't go that way.

>give up
Nothing stops you from giving up. Nothing gives you meaning.

>give up
Nothing stops you from giving up. Nothing gives you meaning.

>i
You are carrying:
  a meaning
  a solutions manual

>w
You can't go that way.

* * *

>n
You can't go that way.

>s
Old Mall
The hallway opens up into what appears to be an empty shopping mall. There is a high domed cieling with skylights overhead. The floor transitions from the carpeted hallway to over-large tan octagonal tiles. They air is cool here and slightly more humid, as if there were a water source nearby. You think you may even hear the distant trickle of water. A few small trees can be seen in planters, spaced decoratively. In contrast to the tense and silent hallway, this space is pleasant and serene. You can see the entrance to several shops. The Ordinary Shop is to the northeast, the Extraordinary Shop is to the northwest, and The Lonely and Dark stores are to the east and west respectively. There is also an escalator leading up to a second floor.

You can go north to the Ordinary Room, south, southwest, east, west and up from here.

>n
Ordinary Room
This room is completely dark.

You can see nothing here.

You can go south to the Old Mall from here.

>s
Old Mall
The hallway opens up into what appears to be an empty shopping mall. There is a high domed cieling with skylights overhead. The floor transitions from the carpeted hallway to over-large tan octagonal tiles. They air is cool here and slightly more humid, as if there were a water source nearby. You think you may even hear the distant trickle of water. A few small trees can be seen in planters, spaced decoratively. In contrast to the tense and silent hallway, this space is pleasant and serene. You can see the entrance to several shops. The Ordinary Shop is to the northeast, the Extraordinary Shop is to the northwest, and The Lonely and Dark stores are to the east and west respectively. There is also an escalator leading up to a second floor.

You can go north to the Ordinary Room, south, southwest, east, west and up from here.

>drop meaning
Dropped.

>n
Ordinary Room
This room is completely dark.

You can see nothing here.

You can go south to the Old Mall from here.

>give up
Nothing stops you from giving up. Nothing gives you meaning.

* * *

>i
You are carrying:
  a meaning
  a solutions manual

>s
Old Mall
The hallway opens up into what appears to be an empty shopping mall. There is a high domed cieling with skylights overhead. The floor transitions from the carpeted hallway to over-large tan octagonal tiles. They air is cool here and slightly more humid, as if there were a water source nearby. You think you may even hear the distant trickle of water. A few small trees can be seen in planters, spaced decoratively. In contrast to the tense and silent hallway, this space is pleasant and serene. You can see the entrance to several shops. The Ordinary Shop is to the northeast, the Extraordinary Shop is to the northwest, and The Lonely and Dark stores are to the east and west respectively. There is also an escalator leading up to a second floor.

You can go north to the Ordinary Room, south, southwest, east, west and up from here.

* * *

>read manual
You flip the pages randomly and arrive at page 6:

It says: "THE WORLD."

>read page 5
(in the solutions manual)
It says: "AMAZING."

>read manual
You flip the pages randomly and arrive at page 2:

It says: "THANK YOU."

>read manual
You flip the pages randomly and arrive at page 4:

It says: "SOMETHING IS WRONG."

>read manual
You flip the pages randomly and arrive at page 4:

It says: "SOMETHING IS WRONG."

>read manual
You flip the pages randomly and arrive at page 2:

It says: "THANK YOU."

* * *

>read manual
You flip the pages randomly and arrive at page 4:

It says: "SOMETHING IS WRONG."

>read manual
You flip the pages randomly and arrive at page 3:

It says: "NOTHING HAS MEANING. LET NOTHING STOP YOU FROM GIVING UP."

>read manual
You flip the pages randomly and arrive at page 1:

It says: "THE DARKNESS OPENS UP."

>read manual
You flip the pages randomly and arrive at page 1:

It says: "THE DARKNESS OPENS UP."

>read manual
You flip the pages randomly and arrive at page 3:

It says: "NOTHING HAS MEANING. LET NOTHING STOP YOU FROM GIVING UP."

* * *

>read manual
You flip the pages randomly and arrive at page 1:

It says: "THE DARKNESS OPENS UP."

>read manual
You flip the pages randomly and arrive at page 5:

It says: "THIS WAY."

>give up
When you decide to give up, nothing can stop you.

    *** YOU HAVE GIVEN UP ***

Would you like to RESTART, RESTORE a saved game, QUIT or UNDO the last command?

>i
Please give one of the answers above.

Would you like to RESTART, RESTORE a saved game, QUIT or UNDO the last command?

>undo
Bedroom
[Previous turn undone.]

>i
You are carrying:
  a solutions manual

* * *

>read
(the solutions manual)
You flip the pages randomly and arrive at page 2:

It says: "Thank you."

>read sign
You can't see any such thing.

>l
Ordinary Room
This room is completely dark.

You can see nothing here.

You can go south from here.

>read nothing
There are no pages in nothing.

* * *

>read nursery rhyme
ELORA 

Elora keeps a tiny box beside her bed. 
And every night when she retires,
she pulls a sticky silver thread
straight between her eyes and out her forehead.
 
At length, she's pulled a dozen feet or so.
She tears it off between her teeth,
and bundles it between her thumbs,
and in the box it goes.

Like spider silk, the substance soon restores.
Each night she must extract a little more.
A bit of string's no burden on a box,
but soon it filled to bursting, so she fetched the locks.

A key for a lid, a box for a key, a lid for the box that held it.
A second, a third, and every box so full she could barely close it.
A fortnight or two and she's bricked herself completely into her room.
Then over the balcony the boxes go "till she's bricked her windows too.

Then at last a night came she had no place left to keep it.
The sticky substance filled her head; she'd no choice but to see it.
 And then it filled her up so much it dripped into her eyes.
And across her vision cast a veil of webby spider ties.

* * *

>examine text
A poem written in violet ink is printed on a lavender page, decorated with bursts of royal blue and gold. In the bottom right corner is an illustration of a little girl lying in bed with a hole in her forehead. It looks like it might be a page out of a children's book.

>look
Bedroom
This looks like a bedroom. There is a bed, a wardrobe, and a mirror. There is also a small night light plugged into an outlet in the wall.

The night light is off.

There is a framed text on the wall. It looks like a nursery rhyme.

You can also see a wardrobe (closed) and a cabinet (closed) here.

You can go east from here.

>open cabinet
As you reach for the cabinet, you realize that you cannot touch it. Your hand falls to your side.

>examine text
A poem written in violet ink is printed on a lavender page, decorated with bursts of royal blue and gold. In the bottom right corner is an illustration of a little girl lying in bed with a hole in her forehead. It looks like it might be a page out of a children's book.

>read text
ELORA 

Elora keeps a tiny box beside her bed. 
And every night when she retires,
she pulls a sticky silver thread
straight between her eyes and out her forehead.
 
At length, she's pulled a dozen feet or so.
She tears it off between her teeth,
and bundles it between her thumbs,
and in the box it goes.

Like spider silk, the substance soon restores.
Each night she must extract a little more.
A bit of string's no burden on a box,
but soon it filled to bursting, so she fetched the locks.

A key for a lid, a box for a key, a lid for the box that held it.
A second, a third, and every box so full she could barely close it.
A fortnight or two and she's bricked herself completely into her room.
Then over the balcony the boxes go "till she's bricked her windows too.

Then at last a night came she had no place left to keep it.
The sticky substance filled her head; she'd no choice but to see it.
 And then it filled her up so much it dripped into her eyes.
And across her vision cast a veil of webby spider ties.

* * *

>read text
ELORA 

Elora keeps a tiny box beside her bed. 
And every night when she retires,
she pulls a sticky silver thread
straight between her eyes and out her forehead.
 
At length, she's pulled a dozen feet or so.
She tears it off between her teeth,
and bundles it around her thumbs,
and in the box it goes.

Like spider silk, the substance soon restores.
Each night she must extract a little more.
A bit of string's no burden on a box,
but soon it filled to bursting, so she fetched the locks.

A key for a lid, a box for a key, a lid for the box that held it.
A second, a third, and every box so full she could barely close it.
A fortnight or two and she's bricked herself completely into her room.
Then over the balcony the boxes go 'till she's bricked her windows too.

Then at last a night came she had no place left to keep it.
The sticky substance filled her head; she'd no choice but to see it.
 And then it filled her up so much it dripped into her eyes.
And across her vision cast a veil of webby spider ties.

>examine rhyme
A poem written in violet ink is printed on a lavender page, decorated with bursts of royal blue and gold. In the bottom right corner is an illustration of a little girl lying in bed with a hole in her forehead. It looks like it might be a page out of a children's book.

* * *

>examine text
A poem written in violet ink is printed on a lavender page and decorated with bursts of gold and royal blue. In the bottom right corner is an illustration of a little girl lying in bed with a hole in her forehead. It looks like it might be a page out of a children's book.

* * *

>examine nightstand
On the nightstand is an ornamental box.

>open nightstand
It isn't something you can open.

>examine drawer
You see nothing special about the drawer.

* * *

>examine nightstand
On the nightstand is an ornamental box.

>open drawer
You open the drawer.

* * *

>read book
The writing is all blurry. You can't make it out.

>read
(the solutions manual)
You flip the pages randomly and arrive at page 5:

It says: "Another Hint"

>read
(the solutions manual)
You flip the pages randomly and arrive at page 1:

It says: "The darkness opens up."

>read
(the solutions manual)
You flip the pages randomly and arrive at page 3:

It says: "Nothing has meaning. If you want to give up, let nothing stop you."

>give up
*** When you decide to give up, nothing can stop you. ***

Would you like to RESTART, RESTORE a saved game, QUIT or UNDO the last command?

>undo
Bedroom
[Previous turn undone.]

>read next page
(in the solutions manual)
It says: "Hint"

>read first page
(in the solutions manual)
It says: "The darkness opens up."

* * *

>read book
The writing is all blurry. You can't make it out.

>wear glasses
(first taking the pair of glasses)
You put on the pair of glasses.

>read book
The first page says: "YOU ARE READING THIS BOOK."

>wait
The next page says: "YOU ARE STILL READING THIS BOOK."

>wait
The next page says: "YOU ARE STILL READING THIS BOOK."

>wait
The next page says: "YOU ARE STILL READING THIS BOOK."
All this reading is making you tried.

>wait
The next page says: "YOU ARE STILL READING THIS BOOK."
The more you read, the more tired you feel.

>wait
The next page says: "YOU ARE STILL READING THIS BOOK."
You feel drained. It's getting harder to understand the words.

>l
The next page says: "YOU ARE STILL READING THIS BOOK."
You're exhausted. It's getting hard to think of anything at all.

>l
The next page says: "YOU ARE STILL READING THIS BOOK."
You feel as if you might pass out soon.

>l
The next page says: "YOU HAVE FINISHED..." 
The book drops from your hand as you fall asleep mid-sentence, sinking into warm darkness. Time passes, and you awake lying face-down on the carpet in an unfamiliar hallway. There is something strange about this place, but you can't quite explain it. You also sense that something important has changed. You feel a vague but persistent tension growing in the back of your mind. You slowly stand, and after a brief dizzy spell, regain your footing,
Hallway
This is a long hallway that seems to stretch endlessly in either direction.  It is reminiscent of the halls of a fancy hotel; identical doors are spaced regularly along the walls on either side, each of which are outfitted with a black box above the handle designed to accept a key card. The walls are papered with a rich navy and powder-blue damask pattern, and a tightly knitted carpet frames the passage, tracing muted grey and gold stripes down its length. The air feels unnaturally still This is a long hallway that seems to stretch endlessly in either direction.  It is reminiscent of the halls of a fancy hotel; identical doors are spaced regularly along the walls on either side, each of which are outfitted with a black box above the handle designed to accept a key card. The walls are papered with a rich navy and powder-blue damask pattern, and a tightly knitted carpet frames the passage, tracing muted grey and gold stripes down its length. The air feels unnaturally still 

You can go north, south, east and west from here.

* * *

>read book
The first page says: "YOU ARE READING THIS BOOK."

>l
The next page says: "YOU ARE STILL READING THIS BOOK."

>l
The next page says: "YOU ARE STILL READING THIS BOOK."

>l
The next page says: "YOU ARE STILL READING THIS BOOK."

All this reading is making you tried.

>l
The next page says: "YOU ARE STILL READING THIS BOOK."

The more you read, the more tired you feel.

>l
The next page says: "YOU ARE STILL READING THIS BOOK."

You feel drained. It's getting harder to understand the words.

>l
The next page says: "YOU ARE STILL READING THIS BOOK."

You're exhausted. It's getting hard to think of anything at all.

>l
The next page says: "YOU ARE STILL READING THIS BOOK."

You feel as if you might pass out soon.

>l
The next page says: "YOU HAVE FINISHED..." 
The book drops from your hand as you fall asleep mid-sentence, sinking into warm darkness. Time passes, and you awake lying face-down on the carpet in an unfamiliar hallway. There is something strange about this place, but you can't quite explain it. You also sense that something important has changed. You feel a vague but persistent tension growing in the back of your mind. You slowly stand, and after a brief dizzy spell, regain your footing.

Hallway
This is a long hallway that seems to stretch endlessly in either direction.  It is reminiscent of the halls of a fancy hotel; identical doors are spaced regularly along the walls on either side, each of which are outfitted with a black box above the handle designed to accept a key card. The walls are papered with a rich navy and powder-blue damask pattern, and a tightly knitted carpet frames the passage, tracing muted grey and gold stripes down its length. The air feels unnaturally still 
The obvious exits are north, south, east and west.

>read book
You can't see any such thing.

>i
You are carrying:
  a pair of glasses (being worn)
  a booze
  a solutions manual

* * *

>wait
Time passes.

>read
(the solutions manual)
You flip the pages randomly and arrive at page 3:

It says: "NOTHING HAS MEANING. 
 LET NOTHING STOP YOU FROM GIVING UP."

Something tells you  (put conditional here later)

>I
You are carrying:
  a solutions manual

Something tells you  (put conditional here later)

>read
(the solutions manual)
You flip the pages randomly and arrive at page 5:

It says: "Another Hint"

Something tells you  (put conditional here later)

>read
(the solutions manual)
You flip the pages randomly and arrive at page 1:

It says: "THE DARKNESS OPENS UP."

Something tells you  (put conditional here later)

>read
(the solutions manual)
You flip the pages randomly and arrive at page 2:

It says: "THANK YOU."

Something tells you  (put conditional here later)

>w
You can't go that way.

>e
Old Mall
The hallway opens up into what appears to be an empty shopping mall. There is a high domed cieling with skylights overhead. The floor transitions from the carpeted hallway to over-large tan octagonal tiles. They air is cool here and slightly more humid, as if there were a water source nearby. You think you may even hear the distant trickle of water. A few small trees can be seen in planters, spaced decoratively. In contrast to the tense and silent hallway, this space is pleasant and serene. You can see the entrance to several shops. The Ordinary Shop is to the northeast, the Extraordinary Shop is to the northwest, and The Lonely and Dark stores are to the east and west respectively. There is also an escalator leading up to a second floor.

You can go north, south, southwest, east, west to the Extraordinary Room and up from here.

>wait
Time passes.

>e
Hallway
You are standing in the middle a long hallway that seems to stretch endlessly in either direction.  It is reminiscent of the halls that one might see in a fancy hotel; identical doors are spaced regularly along the walls on either side, each of which are outfitted with a black box above the handle designed to accept a key card. The walls are papered with a rich navy and powder-blue damask pattern, and a tightly knitted carpet frames the passage, tracing muted grey and gold stripes down its length.  The air feels unnaturally still here.

You can go north, south and west to the Old Mall from here.

>e
You can't go that way.

* * *

>w
You can't go that way.

>n
Hallway
You are standing in the middle a long hallway that seems to stretch endlessly in either direction.  It is reminiscent of the halls that one might see in a fancy hotel; identical doors are spaced regularly along the walls on either side, each of which are outfitted with a black box above the handle designed to accept a key card. The walls are papered with a rich navy and powder-blue damask pattern, and a tightly knitted carpet frames the passage, tracing muted grey and gold stripes down its length.  The air feels unnaturally still here.

You can go north, south to the Hallway, east and west from here.

>e
Place Where you Shouldn't Be
This is a square room with little ornamentation. You feel as if you shouldn't be here.

You can see a black door here.

You can go north through the black door (closed) and west to the Hallway from here.

* * *

>wait
Time passes.

>wait
Time passes.

>wait
that might have been poisoned you know

* * *

>wait
Time passes.

>wear glasses
(first taking the pair of glasses)
You put on the pair of glasses.

>look
Everything is out of focus, except for a single red book on the bookcase

>read book
The first page says: "YOU ARE READING THIS BOOK."

I beg your pardon?

>wait
The next page says: "YOU ARE STILL READING THIS BOOK."

>wait
The next page says: "YOU WILL CONTINUE READING THIS BOOK."

>wait
The next page says: "YOU ARE STILL READING THIS BOOK."

>wait
The next page says: "YOU WILL CONTINUE READING THIS BOOK."
All this reading is making you tried.

* * *

>wait
Time passes.

>look
Hallway
 test

You can go north, south, east and west from here.

>s
You walk some distance down the length of the hallway until you arrive at the next set of adjacent doors

Hallway
You are standing in the middle a long hallway that seems to stretch endlessly in either direction.  It is reminiscent of the halls that one might see in a fancy hotel; identical doors are spaced regularly along the walls on either side, each of which are outfitted with a black box above the handle designed to accept a key card. The walls are papered with a rich navy and powder-blue damask pattern, and a tightly knitted carpet frames the passage, tracing muted grey and gold stripes down its length.  The air feels unnaturally still here.

You can go north to the Hallway, south, east and west from here.

>n
You walk some distance down the length of the hallway until you arrive at the next set of adjacent doors

Hallway
 test

You can go north, south to the Hallway, east and west from here.

* * *

>read book
The first page says: "YOU ARE READING THIS BOOK."

>wait
It says: "YOU ARE STILL READING THIS BOOK."

>wait
The next page says: "YOU WILL CONTINUE READING THIS BOOK."

* * *

>talk
That's not a verb I recognise.

>wait
Something tells you  (put conditional here later)

* * *

>take something
You can't see any such thing.

>i
Something tells you  (put conditional here later)

>take something
You can't see any such thing.

* * *

>take boxes
Taken.

>look
Bedroom
This looks like a child's bedroom.

There is a framed text on the wall. It looks like a nursery rhyme.

You can also see a wardrobe (closed), a cabinet (closed) and a nightstand here.

You can go east from here.

>examine boxes
You see nothing special about the boxes.

* * *

>examine wardrobe
You see nothing special about the wardrobe.

>open wardrobe
You open the wardrobe, revealing a box selection.

* * *

>open wardrobe
You open the wardrobe, revealing many tiny boxes.

>take box
Which do you mean, the tiny boxes or the ornamental box?

>take tiny box
You take one tiny box.

>look
Bedroom
This looks like a child's bedroom.

There is a framed text on the wall. It looks like a nursery rhyme.

You can also see a wardrobe (in which is a tiny box), a cabinet (closed) and a nightstand (on which is an ornamental box) here.

You can go east from here.

* * *

>take tiny box
You take one tiny box.

>i
You are carrying:
  a tiny box
  a solutions manual

>take tiny box
(the tiny boxes)
Taken.

>i
You are carrying:
  two tiny boxes
  a solutions manual

* * *

>take all
tiny boxes: Taken.
ornamental box: Taken.

>i
You are carrying:
  an ornamental box
  three tiny boxes
  a solutions manual

* * *

>take tiny box
You take one tiny box.

>take all
tiny boxes: You take one tiny box.
ornamental box: Taken.

>open tiny box
(the tiny box)
It isn't something you can open.

* * *

>open box
(the tiny box)
it doesn't have a lid.

* * *

>take box
Which do you mean, the tiny boxes or the ornamental box?

>take boxes
You take one tiny box.

>look
Bedroom
This looks like a child's bedroom.

There is a framed text on the wall. It looks like a nursery rhyme.

You can also see a wardrobe (in which is many tiny boxes), a cabinet (closed) and a nightstand (on which is an ornamental box) here.

You can go east from here.

>examine rhyme
A poem written in violet ink is printed on a lavender page and decorated with bursts of gold and royal blue. In the bottom right corner is an illustration of a little girl lying in bed with a hole in her forehead. It looks like it might be a page out of a children's book.

>read rhyme
ELORA 

Elora keeps a tiny box beside her bed. 
And every night when she retires,
she pulls a sticky silver thread
straight between her eyes and out her forehead.
 
At length, she's pulled a dozen feet or so.
She tears it off between her teeth,
and bundles it around her thumbs,
and in the box it goes.

Like spider silk, the substance soon restores.
Each night she must extract a little more.
A bit of string's no burden on a box,
but soon it filled to bursting, so she fetched the locks.

A key for a lid, a box for a key, a lid for the box that held it.
A second, a third, and every box so full she could barely close it.
A fortnight or two and she's bricked herself completely into her room.
Then over the balcony the boxes go 'till she's bricked her windows too.

Then at last a night came she had no place left to keep it.
The sticky substance filled her head; she'd no choice but to see it.
 And then it filled her up so much it dripped into her eyes.
And across her vision cast a veil of webby spider ties.

>examine boxes
You can't use multiple objects with that verb.

>examine tiny boxes
You can't use multiple objects with that verb.

>examine box selection
Tiny wooden boxes, all of which are missing their lid.

>examine tiny box
You see nothing special about the tiny box.

>examine wardrobe
In the wardrobe is many tiny boxes.

* * *

>take box
Which do you mean, the tiny boxes or the ornamental box?

>tiny
You take one tiny box.

>examine tiny box
(the tiny box)
A tiny wooden box. The lid is missing.

>take all boxes
tiny boxes: You take one tiny box.

>examine ornamental box
You see nothing special about the ornamental box.

>examine tiny box
(the tiny box)
A tiny wooden box. The lid is missing.

>l
Bedroom
This looks like a child's bedroom.

There is a framed text on the wall. It looks like a nursery rhyme.

You can also see a wardrobe (in which is many tiny boxes), a cabinet (closed) and a nightstand (on which is an ornamental box) here.

You can go east from here.

* * *

>open wardrobe
You open the wardrobe, revealing many tiny boxes.

>examine boxes
Tiny wooden boxes, all of which are missing their lid.

>examine tiny boxes
Tiny wooden boxes, all of which are missing their lid.

* * *

>examine boxes
Tiny wooden boxes, all of which are missing their lid.

>take box
Which do you mean, the tiny boxes or the ornamental box?

* * *

>take tiny box
You take one tiny box.

>examine tiny box
(the tiny box)
You see nothing special about the tiny box.

>examine tiny boxes
You can't use multiple objects with that verb.

>examine boxes in wardrobe
You can't use multiple objects with that verb.

>examine boxes
You can't use multiple objects with that verb.

>drop tiny box
(the tiny box)
Dropped.

>examine tiny box
(the tiny box)
You see nothing special about the tiny box.

>examine boxes
You can't use multiple objects with that verb.

* * *

>examine tiny boxes
You can't use multiple objects with that verb.

>take box
(the tiny box)
Taken.

>examine wardrobe
In the wardrobe is many tiny boxes.

>examine tiny box
(the tiny box)
You see nothing special about the tiny box.

* * *

>open wardrobe
You open the wardrobe, revealing many tiny boxes.

>take boxes
You can't see any such thing.

* * *

>open wardrobe
You open the wardrobe, revealing many tiny boxes.

>take tiny box
You take one tiny box.

* * *

>examine tiny box
(the tiny box)
You see nothing special about the tiny box.

>examine tiny boxes
You see nothing special about the tiny box.

* * *

>ioeb vi
That's not a verb I recognise.

>open bo
You can't see any such thing.

>open wardrobe
You open the wardrobe, revealing many tiny boxes.

>open box
Which do you mean, the tiny boxes or the ornamental box?

>open tiny box
It isn't something you can open.

>take tiny box
You take one tiny box.

>open tiny box
(the tiny box)
it doesn't have a lid.

>w
You can't go that way.

>e
Hallway
You are standing in the middle a long hallway that seems to stretch endlessly in either direction.  It is reminiscent of the halls that one might see in a fancy hotel; identical doors are spaced regularly along the walls on either side, each of which are outfitted with a black box above the handle designed to accept a key card. The walls are papered with a rich navy and powder-blue damask pattern, and a tightly knitted carpet frames the passage, tracing muted grey and gold stripes down its length.  The air feels unnaturally still here.

A neat section of the blue damask wall paper has torn, revealing a patch of yellow beneath it. You admire the torn piece.

You can also see a steel knife here.

You can go north, south, east and west to the Bedroom from here.

>open tiny box
it doesn't have a lid.

I beg your pardon?

>w
Bedroom
This looks like a child's bedroom.

There is a framed text on the wall. It looks like a nursery rhyme.

You can also see a wardrobe (in which is many tiny boxes), a cabinet (closed) and a nightstand (on which is an ornamental box) here.

You can go east to the Hallway from here.

>examine boxes
You see nothing special about the tiny box.

>examine tiny boxes
You see nothing special about the tiny box.

* * *

>ACTIONS
Actions listing on.

>look
[looking]
Bedroom
This looks like a child's bedroom.

There is a framed text on the wall. It looks like a nursery rhyme.

You can also see a wardrobe (closed), a cabinet (closed) and a nightstand (on which is an ornamental box) here.

You can go east from here.

[looking - succeeded]

>open wardrobe
[opening the wardrobe]
You open the wardrobe, revealing many tiny boxes.
[opening the wardrobe - succeeded]

>examine boxes
[examining the tiny boxes]
Tiny wooden boxes, all of which are missing their lid.

[examining the tiny boxes - succeeded]

>take box
Which do you mean, the tiny boxes or the ornamental box?

>take tiny box
You can't see any such thing.

* * *

>ACTIONS
Actions listing on.

>open wardrobe
[opening the wardrobe]
You open the wardrobe, revealing many tiny boxes.
[opening the wardrobe - succeeded]

>take boxes
You can't see any such thing.

>take box
Which do you mean, the tiny boxes or the ornamental box?

* * *

>ACTIONS
Actions listing on.

>drink booze
[drinking the booze]
There's nothing suitable to drink here.
[drinking the booze - failed the block drinking rule]

* * *

>examine box
You see nothing special about the ornamental box.

>open box
It isn't something you can open.

>open ornamental box
It isn't something you can open.

* * *

>open ornamental bo
I only understood you as far as wanting to open the ornamental box.

>open ornamental box
It isn't something you can open.

* * *

>open ornamental box
It isn't something you can open.

* * *

>examine ornamental box
You see nothing special about the ornamental box.

>open ornamental box
It isn't something you can open.

* * *

>open cute box
It seems to be locked.

* * *

>open nightstand
You open the drawer.

* * *

>open drawer
You open the drawer, revealing many tiny keys.

>examine drawer
The drawer is empty.

* * *

>open drawer
You open the drawer, revealing many tiny keys.

>take key
You take one tiny key.

>examine key
(the tiny key)
A tiny gold key

>take all keys
tiny keys: You take one tiny key.

>i
You are carrying:
  two tiny keys
  a solutions manual

>open wardrobe
You open the wardrobe, revealing many tiny boxes.

* * *

>take tiny box
You take one tiny box.

>open box with key
(the tiny box with the tiny key)
That doesn't seem to be something you can unlock.

>examine tiny box
(the tiny box)
A tiny wooden box. The lid is missing.

>open ornamental box with tiny key
(the tiny key)
That doesn't seem to fit the lock.

* * *

>examine case
In the display case are a spellbook, a linking book, an encycolpedia frobozzica, a coin pouch and a strange orb.

There is a small notice taped to the glass on top of the display case.

>look
Library
The narrow doorway opens up intos a large, comfortable library with a vaulted cieling. Sofas and wing-backed chairs are tastefully framed by tall bookshelves lining each of the back walls.

Near the center of the room there is a glass display case containing many curious items.

You can see no obvious exits.

>examine case
The display case is empty.

* * *

>examine case
In the display case are a spellbook, a linking book, an encycolpedia frobozzica, a coin pouch and a strange orb.

There is a small notice taped to the glass on top of the display case.

>read notice
There are no pages in the notice.

* * *

>examine case
In the display case are a spellbook, a linking book, an encycolpedia frobozzica, a coin pouch and a strange orb.

There is a small notice taped to the glass on top of the display case.

>examine orb
Gazing into the orb, you can see the outlines of many people. They are frozen in place, as if time were stopped.

>open case
It seems to be locked.

* * *

>examine display case
In the display case are a spellbook, a linking book, an encycolpedia frobozzica and a coin pouch.

* * *

>read notice
It says: "Rare items from oft-imagined worlds."

* * *

>turn off fan
You switch the fan off.

* * *

>examine file cabinets
You see nothing special about the file cabinets.

>take cabinets
Taken.

* * *

>examine first cabinet
You can't see any such thing.

>examine cabinet
You can't see any such thing.

* * *

>examine file cabinet
I only understood you as far as wanting to examine 3 file cabinets.

>examine cabinets
You see nothing special about 3 file cabinets.

>open cabinet
You can't see any such thing.

>open cabinets
You open 3 file cabinets.

>close 2 cabinets
You can't use multiple objects with that verb.

* * *

>examine cabinets
You see nothing special about the file cabinets.

>open cabinet
You can't see any such thing.

* * *

>E
Hallway
You are standing in the middle a long hallway that seems to stretch endlessly in either direction.  It is reminiscent of the halls that one might see in a fancy hotel; identical doors are spaced regularly along the walls on either side, each of which are outfitted with a black box above the handle designed to accept a key card. The walls are papered with a rich navy and powder-blue damask pattern, and a tightly knitted carpet frames the passage, tracing muted grey and gold stripes down its length.  The air feels unnaturally still here.

You can go north, south, east and west to the Narrow Corridor from here.

>w
Narrow Corridor
You can go east to the Hallway and west from here.

>n
You can't go that way.

>w
A draft of air blows past you and the corridor opens up into an impossibly large space. For a moment you feel dizzy as you are overcome by a sudden awareness of your relative smallness. You briefly gaze upward at the huge and distant cieling...

Library Entrance
You are standing in a massive cillindrical atrium which rises twelve stories from ground level terminating in a wide, domed, blue glass cieling. The entire outer wall is lined with shelves of leather-bound books of irregular shape and color. Also spaced along the cylindrical wall are four equidistant spiral staircases that wind clockwise all the way to the top, with landings at each level. Chic and varied pieces furniture are strategically placed throughout, creating many small comfortable pockets for reclusive reading, Everything, including the stairs, is made with lustrous pieces of rich, polished mahogany. In the center of the dome, some distance away and to the west, you can see what looks to be the library's front desk, though it is hard to tell since the building is completely empty. 

You can go east to the Narrow Corridor and west from here.

>e
Narrow Corridor
You can go east to the Hallway and west to the Library Entrance from here.

>e
Hallway
You are standing in the middle a long hallway that seems to stretch endlessly in either direction.  It is reminiscent of the halls that one might see in a fancy hotel; identical doors are spaced regularly along the walls on either side, each of which are outfitted with a black box above the handle designed to accept a key card. The walls are papered with a rich navy and powder-blue damask pattern, and a tightly knitted carpet frames the passage, tracing muted grey and gold stripes down its length.  The air feels unnaturally still here.

You can go north, south, east and west to the Narrow Corridor from here.

>n
Hallway
You are standing in the middle a long hallway that seems to stretch endlessly in either direction.  It is reminiscent of the halls that one might see in a fancy hotel; identical doors are spaced regularly along the walls on either side, each of which are outfitted with a black box above the handle designed to accept a key card. The walls are papered with a rich navy and powder-blue damask pattern, and a tightly knitted carpet frames the passage, tracing muted grey and gold stripes down its length.  The air feels unnaturally still here.

You can go north, south to the Hallway, east and west from here.

>e
YOU SHOULDN'T BE HERE
This is a square room with little ornamentation. You feel as if you shouldn't be here.

You can see a black door here.

You can go north through the black door (closed) and west to the Hallway from here.

>examine door
It frightens you.

* * *

>open door
It seems to be locked.

>w
Hallway
You are standing in the middle a long hallway that seems to stretch endlessly in either direction.  It is reminiscent of the halls that one might see in a fancy hotel; identical doors are spaced regularly along the walls on either side, each of which are outfitted with a black box above the handle designed to accept a key card. The walls are papered with a rich navy and powder-blue damask pattern, and a tightly knitted carpet frames the passage, tracing muted grey and gold stripes down its length.  The air feels unnaturally still here.

You can go north, south to the Hallway, east to the YOU SHOULDN'T BE HERE and west from here.

>read manual
You flip the pages randomly and arrive at page 3:

It says: "NOTHING HAS MEANING. LET NOTHING STOP YOU FROM GIVING UP."

>read manual
You flip the pages randomly and arrive at page 5:

It says: "AMAZING."

>read manual
You flip the pages randomly and arrive at page 6:

It says: "THE WORLD."

>read manual
You flip the pages randomly and arrive at page 2:

It says: "THANK YOU."

* * *

>listen
You hear nothing unexpected.

>ACTIONS
Actions listing on.

>listen
[listening to the Narrow Corridor]
You hear nothing unexpected.
[listening to the Narrow Corridor - succeeded]

* * *

>read plaque
it says: 
"LIBRARY
(Caution: When in Evanidus, this door will not exist.)"

* * *

>open door with card
You unlock the unusual door.

>w
You open the unusual door.

A draft of air blows past you and the corridor opens up into an impossibly large space. For a moment you feel dizzy as you are overcome by a sudden awareness of your relative smallness. You gaze upward at the huge and distant cieling...

Library Entrance
You are standing in a massive cillindrical atrium which rises twelve stories from ground level terminating in a wide domed cieling of blue glass. On this level, the entire outer wall is lined with shelves of leather-bound books of irregular shape and color. Also spaced along the cylindrical wall are four equidistant spiral staircases that wind clockwise all the way to the top, with landings at each level. Looking up, you can see that each of the floors above are filled with countless winding isles of bookcases that stretch back into unseen parts of the building. Chic and varied pieces of blue and yellow furniture are strategically placed throughout, creating many small comfortable pockets for reclusive reading, Everything, including the stairs, is made with lustrous pieces of rich, polished mahogany. In the center of the dome, some distance away and to the west, you can see what looks to be the library's front desk, though it is hard to tell since the building is completely empty. 

You can see an unusual door here.

You can go east through the unusual door to the Narrow Corridor and west from here.

>e
Narrow Corridor
This narrow corridor branches off of the main hallway. There is a door to the west that looks slightly different from the others. The wood is richer and brighter, and it opens outward rather than inward. A brass plaque is posted on the wall next to it.

You can see an unusual door and a brass plaque here.

You can go east and west through the unusual door to the Library Entrance from here.

>e
Hallway
You are standing in the middle a long hallway that seems to stretch endlessly in either direction.  It is reminiscent of the halls that one might see in a fancy hotel; identical doors are spaced regularly along the walls on either side, each of which are outfitted with a black box above the handle designed to accept a key card. The walls are papered with a rich navy and powder-blue damask pattern, and a tightly knitted carpet frames the passage, tracing muted grey and gold stripes down its length.  The air feels unnaturally still here.

You can go north, south, east and west to the Narrow Corridor from here.

>e
Records Room
This is an austere looking room with beige tile floors below and white flourescent lighting overhead. A number of file cabinets line the north and south walls. In the furthest corner is a grey metal desk with two locking drawers and a bankers lamp with a green glass shade. It is uncomfortably warm in here. In the corner, standing metal fan is noisily failing to cool it.

You can see a metal fan and some file cabinets here.

You can go east and west to the Hallway from here.

>e
The Archives
The room opens up into a wide, sprawling space, the center of which is filled with rows upon rows of identical metal desks. The rest of the room is dominated by parallel isles of grey shelving, each of which is stacked with important-looking documents.

You can see Foster here.

You can go west to the Records Room from here.

>w
Records Room
This is an austere looking room with beige tile floors below and white flourescent lighting overhead. A number of file cabinets line the north and south walls. In the furthest corner is a grey metal desk with two locking drawers and a bankers lamp with a green glass shade. It is uncomfortably warm in here. In the corner, standing metal fan is noisily failing to cool it.

You can see a metal fan and some file cabinets here.

You can go east to the The Archives and west to the Hallway from here.

>w
Hallway
You are standing in the middle a long hallway that seems to stretch endlessly in either direction.  It is reminiscent of the halls that one might see in a fancy hotel; identical doors are spaced regularly along the walls on either side, each of which are outfitted with a black box above the handle designed to accept a key card. The walls are papered with a rich navy and powder-blue damask pattern, and a tightly knitted carpet frames the passage, tracing muted grey and gold stripes down its length.  The air feels unnaturally still here.

You can go north, south, east to the Records Room and west to the Narrow Corridor from here.

* * *

>examine door
It frightens you.

>w
Hallway
You are standing in the middle a long hallway that seems to stretch endlessly in either direction.  It is reminiscent of the halls that one might see in a fancy hotel; identical doors are spaced regularly along the walls on either side, each of which are outfitted with a black box above the handle designed to accept a key card. The walls are papered with a rich navy and powder-blue damask pattern, and a tightly knitted carpet frames the passage, tracing muted grey and gold stripes down its length.  The air feels unnaturally still here.

You can go north, south to the Hallway, east to the Place Where you Shouldn't Be and west from here.

>n
Hallway
You are standing in the middle a long hallway that seems to stretch endlessly in either direction.  It is reminiscent of the halls that one might see in a fancy hotel; identical doors are spaced regularly along the walls on either side, each of which are outfitted with a black box above the handle designed to accept a key card. The walls are papered with a rich navy and powder-blue damask pattern, and a tightly knitted carpet frames the passage, tracing muted grey and gold stripes down its length.  The air feels unnaturally still here.

A neat section of the blue damask wall paper has torn, revealing a patch of yellow beneath it. You admire the torn piece.

You can also see a steel knife here.

You can go north, south to the Hallway, east and west from here.

>take piece
Holding the torn piece between two fingers, you pull gently, and a section of paper is smoothly stripped away. Yellow wall paper is revealed behind it, printed with an identical damask pattern in white. This paper however is blemished by the presence of a now-visible crack in the drywall that branches in every direction, meeting at a point beneath the spot where the paper was lifted. You can see something inside.

Taken.

>examine crack
You see nothing special about the crack.

>take knife
Taken.

>w
Bedroom
This looks like a child's bedroom.

There is a framed text on the wall. It looks like a nursery rhyme.

Against the far wall is a small white nightstand with a single drawer.

On the nightstand is an ornamental box.

You can also see a wardrobe and a cabinet here.

You can go east to the Hallway from here.

>open wardrobe
You open the wardrobe, revealing many tiny boxes.

>take bo
You can't see any such thing.

>take box
Which do you mean, the tiny boxes or the ornamental box?

* * *

>tiny
You take one tiny box.

>take ornamental box
Taken.

>open drawer
You open the drawer, revealing many tiny keys.

* * *

>take key
You take one tiny key.

>l
Bedroom
This looks like a child's bedroom.

There is a framed text on the wall. It looks like a nursery rhyme.

Against the far wall is a small white nightstand with a single drawer.

You can also see a wardrobe (in which is many tiny boxes) and a cabinet here.

You can go east to the Hallway from here.

>examine rhyme
A poem written in violet ink is printed on a lavender page and decorated with bursts of gold and royal blue. In the bottom right corner is an illustration of a little girl lying in bed with a hole in her forehead. It looks like it might be a page out of a children's book.

>read rhyme
ELORA 

Elora keeps a tiny box beside her bed. 
And every night when she retires,
she pulls a sticky silver thread
straight between her eyes and out her forehead.
 
At length, she's pulled a dozen feet or so.
She tears it off between her teeth,
and bundles it around her thumbs,
and in the box it goes.

Like spider silk, the substance soon restores.
Each night she must extract a little more.
A bit of string's no burden on a box,
but soon it filled to bursting, so she fetched the locks.

A key for a lid, a box for a key, a lock for the box that held it.
A second, a third, and every box so full she could barely close it.
A fortnight or two and she's bricked herself completely into her room.
Then over the balcony the boxes go 'till she's bricked her windows too.

Then at last a night came she had no place left to keep it.
The sticky substance filled her head; she'd no choice but to see it.
 And then it filled her up so much it dripped into her eyes.
And across her vision cast a veil of webby spider ties.

>l
Bedroom
This looks like a child's bedroom.

There is a framed text on the wall. It looks like a nursery rhyme.

Against the far wall is a small white nightstand with a single drawer.

You can also see a wardrobe (in which is many tiny boxes) and a cabinet here.

You can go east to the Hallway from here.

>open cabinet
As you reach for the cabinet, you realize that you cannot touch it. Your hand falls to your side.

>e
Hallway
You are standing in the middle a long hallway that seems to stretch endlessly in either direction.  It is reminiscent of the halls that one might see in a fancy hotel; identical doors are spaced regularly along the walls on either side, each of which are outfitted with a black box above the handle designed to accept a key card. The walls are papered with a rich navy and powder-blue damask pattern, and a tightly knitted carpet frames the passage, tracing muted grey and gold stripes down its length.  The air feels unnaturally still here.

You can see a crack here.

You can go north, south to the Hallway, east and west to the Bedroom from here.

>n
Hallway
You are standing in the middle a long hallway that seems to stretch endlessly in either direction.  It is reminiscent of the halls that one might see in a fancy hotel; identical doors are spaced regularly along the walls on either side, each of which are outfitted with a black box above the handle designed to accept a key card. The walls are papered with a rich navy and powder-blue damask pattern, and a tightly knitted carpet frames the passage, tracing muted grey and gold stripes down its length.  The air feels unnaturally still here.

You can go north, south to the Hallway and west from here.

>w
Old Mall
The hallway opens up into what appears to be an empty shopping mall. There is a high domed cieling with skylights overhead. The floor transitions from the carpeted hallway to over-large tan octagonal tiles. They air is cool here and slightly more humid, as if there were a water source nearby. You think you may even hear the distant trickle of water. A few small trees can be seen in planters, spaced decoratively. In contrast to the tense and silent hallway, this space is pleasant and serene. You can see the entrance to several shops. The Ordinary Shop is to the northeast, the Extraordinary Shop is to the northwest, and The Lonely and Dark stores are to the east and west respectively. There is also an escalator leading up to a second floor.

You can go north, south, southwest, east to the Hallway, west and up from here.

>e
Hallway
You are standing in the middle a long hallway that seems to stretch endlessly in either direction.  It is reminiscent of the halls that one might see in a fancy hotel; identical doors are spaced regularly along the walls on either side, each of which are outfitted with a black box above the handle designed to accept a key card. The walls are papered with a rich navy and powder-blue damask pattern, and a tightly knitted carpet frames the passage, tracing muted grey and gold stripes down its length.  The air feels unnaturally still here.

You can go north, south to the Hallway and west to the Old Mall from here.

* * *

>e
You can't go that way.

>n
Hallway
You are standing in the middle a long hallway that seems to stretch endlessly in either direction.  It is reminiscent of the halls that one might see in a fancy hotel; identical doors are spaced regularly along the walls on either side, each of which are outfitted with a black box above the handle designed to accept a key card. The walls are papered with a rich navy and powder-blue damask pattern, and a tightly knitted carpet frames the passage, tracing muted grey and gold stripes down its length.  The air feels unnaturally still here.

You can go north to the Hallway, south to the Hallway, east and west from here.

>e
Outside Room
Opening the door reveals what at first looks to be a wide outdoor space filled with shrubs and grasses. A fog hangs in the air above you, obscuring the view upward. The illusion is broken by many white pillars holding up what must be a distant cieling. In the east corner of this large room is a small plastic house.

You can go east and west to the Hallway from here.

>w
Hallway
You are standing in the middle a long hallway that seems to stretch endlessly in either direction.  It is reminiscent of the halls that one might see in a fancy hotel; identical doors are spaced regularly along the walls on either side, each of which are outfitted with a black box above the handle designed to accept a key card. The walls are papered with a rich navy and powder-blue damask pattern, and a tightly knitted carpet frames the passage, tracing muted grey and gold stripes down its length.  The air feels unnaturally still here.

You can go north to the Hallway, south to the Hallway, east to the Outside Room and west from here.

>w
Empty Corridor
This is a long section of empty hallway. Further west, you see that the hallway diverges into similar looking corridors with no doors, no furniture and no ornamentation. You sense that if you keep going to the west, you may become lost. The wallpaper is yellow here.

You can go east to the Hallway and west from here.

>e
Hallway
You are standing in the middle a long hallway that seems to stretch endlessly in either direction.  It is reminiscent of the halls that one might see in a fancy hotel; identical doors are spaced regularly along the walls on either side, each of which are outfitted with a black box above the handle designed to accept a key card. The walls are papered with a rich navy and powder-blue damask pattern, and a tightly knitted carpet frames the passage, tracing muted grey and gold stripes down its length.  The air feels unnaturally still here.

You can go north to the Hallway, south to the Hallway, east to the Outside Room and west to the Empty Corridor from here.

>n
Hallway
You are standing in the middle a long hallway that seems to stretch endlessly in either direction.  It is reminiscent of the halls that one might see in a fancy hotel; identical doors are spaced regularly along the walls on either side, each of which are outfitted with a black box above the handle designed to accept a key card. The walls are papered with a rich navy and powder-blue damask pattern, and a tightly knitted carpet frames the passage, tracing muted grey and gold stripes down its length.  The air feels unnaturally still here.

You can go north to the Hallway, south to the Hallway, east to the Records Room and west to the Narrow Corridor from here.

>n
Hallway
You are standing in the middle a long hallway that seems to stretch endlessly in either direction.  It is reminiscent of the halls that one might see in a fancy hotel; identical doors are spaced regularly along the walls on either side, each of which are outfitted with a black box above the handle designed to accept a key card. The walls are papered with a rich navy and powder-blue damask pattern, and a tightly knitted carpet frames the passage, tracing muted grey and gold stripes down its length.  The air feels unnaturally still here.

You can go north to the Hallway, south to the Hallway, east to the Place Where you Shouldn't Be and west from here.

>w
Foyer
Despite being an isolated room in the middle of a hallway, this room appears to be a foyer. There is a small sofa and a shoe rack along the west wall. On the north wall, there is a clock. There is a staircase in the northwest corner leading down. The bottom of the stairs is in darkness, but you think you percieve the vague outline of a person there.

You can see a shoe rack (on which is a pair of women's heels) here.

You can go northwest and east to the Hallway from here.

>d
There is something terrible about the staircase that chills you to the core. As you take your first step down, you are overcome with waves of fear and weakness. Unnameable images flash through your mind. You gasp for breath, but there is no air. Darkness consumes you as your body falls limp into the void.

Walls
You are standing on a slab of concrete that is four foot square. Around you on every side are grey brick walls that stretch upward indefinitely. Your fear resolves into a grim sense of familiarity, and a heavy burden lifts from your shoulders. You feel oddly at peace.

You can see the walls here.

You can see no obvious exits.

* * *

>feel door
You feel nothing unexpected.

* * *

>take tension
That's not something you can do to your feelings of tension.

* * *

>feel tension
You are a little tense.

>ACTIONS
Actions listing on.

>feel tension
[touching the tension]
You feel nothing unexpected.
[touching the tension - succeeded]

>take tension
[taking the tension]
that isn't something you can do to your feelings of tension.
[taking the tension - failed]

* * *

>eat cookie
You eat the cookie. Not bad.

* * *

>take all
There are none at all available!

>n
Hallway
This is a long hallway that seems to stretch endlessly in either direction.  It is reminiscent of the halls that one might see in a fancy hotel; identical doors are spaced regularly along the walls on either side, each of which are outfitted with a black box above the handle designed to accept a key card. The walls are papered with a rich navy and powder-blue damask pattern, and a tightly knitted carpet frames the passage, tracing muted grey and gold stripes down its length.  The air feels unnaturally still here.

You can go north, south to the Hallway, east and west from here.

>n
Hallway
You are standing in the middle a long hallway that seems to stretch endlessly in either direction.  It is reminiscent of the halls that one might see in a fancy hotel; identical doors are spaced regularly along the walls on either side, each of which are outfitted with a black box above the handle designed to accept a key card. The walls are papered with a rich navy and powder-blue damask pattern, and a tightly knitted carpet frames the passage, tracing muted grey and gold stripes down its length.  The air feels unnaturally still here.

A steel knife is embedded in the wall nearby.

A neat section of the blue damask wall paper has torn, revealing a patch of yellow beneath it. You admire the torn piece.

You can go north, south to the Hallway, east and west from here.

>n
Hallway
You are standing in the middle a long hallway that seems to stretch endlessly in either direction.  It is reminiscent of the halls that one might see in a fancy hotel; identical doors are spaced regularly along the walls on either side, each of which are outfitted with a black box above the handle designed to accept a key card. The walls are papered with a rich navy and powder-blue damask pattern, and a tightly knitted carpet frames the passage, tracing muted grey and gold stripes down its length.  The air feels unnaturally still here.

You can go north, south to the Hallway and west from here.

>n
Hallway
You are standing in the middle a long hallway that seems to stretch endlessly in either direction.  It is reminiscent of the halls that one might see in a fancy hotel; identical doors are spaced regularly along the walls on either side, each of which are outfitted with a black box above the handle designed to accept a key card. The walls are papered with a rich navy and powder-blue damask pattern, and a tightly knitted carpet frames the passage, tracing muted grey and gold stripes down its length.  The air feels unnaturally still here.

You can go north to the Hallway, south to the Hallway, east and west from here.

>n
Hallway
This is a long hallway that seems to stretch endlessly in either direction.  It is reminiscent of the halls that one might see in a fancy hotel; identical doors are spaced regularly along the walls on either side, each of which are outfitted with a black box above the handle designed to accept a key card. The walls are papered with a rich navy and powder-blue damask pattern, and a tightly knitted carpet frames the passage, tracing muted grey and gold stripes down its length.  The air feels unnaturally still here.

You can go north to the Hallway, south to the Hallway, east and west from here.

>n
Hallway
This is a long hallway that seems to stretch endlessly in either direction.  It is reminiscent of the halls that one might see in a fancy hotel; identical doors are spaced regularly along the walls on either side, each of which are outfitted with a black box above the handle designed to accept a key card. The walls are papered with a rich navy and powder-blue damask pattern, and a tightly knitted carpet frames the passage, tracing muted grey and gold stripes down its length.  The air feels unnaturally still here.

You can go north to the Hallway, south to the Hallway, east and west from here.

>s
Hallway
This is a long hallway that seems to stretch endlessly in either direction.  It is reminiscent of the halls that one might see in a fancy hotel; identical doors are spaced regularly along the walls on either side, each of which are outfitted with a black box above the handle designed to accept a key card. The walls are papered with a rich navy and powder-blue damask pattern, and a tightly knitted carpet frames the passage, tracing muted grey and gold stripes down its length.  The air feels unnaturally still here.

You can go north to the Hallway, south to the Hallway, east and west from here.

>s
Hallway
You are standing in the middle a long hallway that seems to stretch endlessly in either direction.  It is reminiscent of the halls that one might see in a fancy hotel; identical doors are spaced regularly along the walls on either side, each of which are outfitted with a black box above the handle designed to accept a key card. The walls are papered with a rich navy and powder-blue damask pattern, and a tightly knitted carpet frames the passage, tracing muted grey and gold stripes down its length.  The air feels unnaturally still here.

You can go north to the Hallway, south to the Hallway, east and west from here.

>s
Hallway
You are standing in the middle a long hallway that seems to stretch endlessly in either direction.  It is reminiscent of the halls that one might see in a fancy hotel; identical doors are spaced regularly along the walls on either side, each of which are outfitted with a black box above the handle designed to accept a key card. The walls are papered with a rich navy and powder-blue damask pattern, and a tightly knitted carpet frames the passage, tracing muted grey and gold stripes down its length.  The air feels unnaturally still here.

You can go north to the Hallway, south to the Hallway and west from here.

>s
Hallway
You are standing in the middle a long hallway that seems to stretch endlessly in either direction.  It is reminiscent of the halls that one might see in a fancy hotel; identical doors are spaced regularly along the walls on either side, each of which are outfitted with a black box above the handle designed to accept a key card. The walls are papered with a rich navy and powder-blue damask pattern, and a tightly knitted carpet frames the passage, tracing muted grey and gold stripes down its length.  The air feels unnaturally still here.

A steel knife is embedded in the wall nearby.

A neat section of the blue damask wall paper has torn, revealing a patch of yellow beneath it. You admire the torn piece.

You can go north to the Hallway, south to the Hallway, east and west from here.

>take knife
Taken.

>use knife on wallpaper
That's not a verb I recognise.

>cut wallpaper with knife
You can't see any such thing.

>l
Hallway
You are standing in the middle a long hallway that seems to stretch endlessly in either direction.  It is reminiscent of the halls that one might see in a fancy hotel; identical doors are spaced regularly along the walls on either side, each of which are outfitted with a black box above the handle designed to accept a key card. The walls are papered with a rich navy and powder-blue damask pattern, and a tightly knitted carpet frames the passage, tracing muted grey and gold stripes down its length.  The air feels unnaturally still here.

A neat section of the blue damask wall paper has torn, revealing a patch of yellow beneath it. You admire the torn piece.

You can go north to the Hallway, south to the Hallway, east and west from here.

>w
Bedroom
This looks like a child's bedroom.

There is a framed text on the wall. It looks like a nursery rhyme.

Against the far wall is a small white nightstand with a single drawer.

On the nightstand is an ornamental box.

You can also see a wardrobe and a cabinet here.

You can go east to the Hallway from here.

>examine rhyme
A poem written in violet ink is printed on a lavender page and decorated with bursts of gold and royal blue. In the bottom right corner is an illustration of a little girl lying in bed with a hole in her forehead. It looks like it might be a page out of a children's book.

>read rhyme
ELORA 

Elora keeps a tiny box beside her bed. 
And every night when she retires,
she pulls a sticky silver thread
straight between her eyes and out her forehead.
 
At length, she's pulled a dozen feet or so.
She tears it off between her teeth,
and bundles it around her thumbs,
and in the box it goes.

Like spider silk, the substance soon restores.
Each night she must extract a little more.
A bit of string's no burden on a box,
but soon it filled to bursting, so she fetched the locks.

A key for a lock, a box for a key, a lid for the box that held it.
A second, a third, and every box so full she could barely close it.
A fortnight or two and she's bricked herself completely into her room.
Then over the balcony the boxes go 'till she's bricked her windows too.

Then at last a night came she had no place left to keep it.
The sticky substance filled her head; she'd no choice but to see it.
 And then it filled her up so much it dripped into her eyes.
And across her vision cast a veil of webby spider ties.

>w
You can't go that way.

>open wardrobe
You open the wardrobe, revealing many tiny boxes.

* * *

>push down button
the elevator starts to move.

>look
Elevator
You can see a down button and an up button here.

You can see no obvious exits.

>ACTIONS
Actions listing on.

>drink button
Which do you mean, the down button or the up button?

>drink up button
[drinking the up button]
There's nothing suitable to drink here.
[drinking the up button - failed the block drinking rule]

* * *

>drink booze
You down it in one gulp. It relaxes you. You can feel the tension in the back of your mind decreasing.
Now you are you are completely relaxed.

>i
You are carrying:
  a cookie
  a solutions manual

>eat cookie
You eat the cookie. Not bad.

* * *

>d
These stairs frighten you. You can feel the tension increasing. You are now you are extremely tense.

>drink booze
You down it in one gulp. It relaxes you. You can feel the tension in the back of your mind decreasing.
Now you are you are slightly tense.

>d
These stairs frighten you. You can feel the tension increasing. You are now you are a little tense.

>u
Halfway Down the Stairs
You can go up to the Stair Landing and down from here.

>u
Stair Landing
You can see a shadowy figure and a staircase here.

You can go southeast and down to the Halfway Down the Stairs from here.

>d
These stairs frighten you. You can feel the tension increasing. You are now you are very tense.

>u
Stair Landing
You can see a shadowy figure and a staircase here.

You can go southeast and down to the Halfway Down the Stairs from here.

* * *

>se
Foyer
Despite being an isolated room in the middle of a hallway, this room appears to be a foyer. There is a small sofa and a shoe rack along the west wall. On the north wall, there is a clock. There is a staircase in the northwest corner leading down. The bottom of the stairs is in darkness, but you think you percieve the vague outline of a person there.

You can see a shoe rack (on which is a pair of women's heels) here.

You can go northwest to the Stair Landing and east from here.

* * *

>e
Hallway
This is a long hallway that seems to stretch endlessly in either direction.  It is reminiscent of the halls that one might see in a fancy hotel; identical doors are spaced regularly along the walls on either side, each of which are outfitted with a black box above the handle designed to accept a key card. The walls are papered with a rich navy and powder-blue damask pattern, and a tightly knitted carpet frames the passage, tracing muted grey and gold stripes down its length.  The air feels unnaturally still here.

You can go north, south, east and west to the Foyer from here.

>s
test

>s
test

>n
test

>n
test

>look
Hallway
This is a long hallway that seems to stretch endlessly in either direction.  It is reminiscent of the halls that one might see in a fancy hotel; identical doors are spaced regularly along the walls on either side, each of which are outfitted with a black box above the handle designed to accept a key card. The walls are papered with a rich navy and powder-blue damask pattern, and a tightly knitted carpet frames the passage, tracing muted grey and gold stripes down its length.  The air feels unnaturally still here.

You can go north, south, east and west to the Foyer from here.

* * *

>se
Foyer
Despite being an isolated room in the middle of a hallway, this room appears to be a foyer. There is a small sofa and a shoe rack along the west wall. On the north wall, there is a clock. There is a staircase in the northwest corner leading down. The bottom of the stairs is in darkness, but you think you percieve the vague outline of a person there.

You can see a shoe rack (on which is a pair of women's heels) here.

You can go northwest to the Stair Landing and east from here.

>sw
You can't go that way.

* * *

>se
You can't go that way.

>w
You can't go that way.

* * *

>e
Hallway
This is a long hallway that seems to stretch endlessly in either direction.  It is reminiscent of the halls that one might see in a fancy hotel; identical doors are spaced regularly along the walls on either side, each of which are outfitted with a black box above the handle designed to accept a key card. The walls are papered with a rich navy and powder-blue damask pattern, and a tightly knitted carpet frames the passage, tracing muted grey and gold stripes down its length.  The air feels unnaturally still here.

You can go north, south, east and west to the Foyer from here.

>n
You walk some distance down the length of the hallway until you arrive at the next set of adjacent doors

Hallway
You are standing in the middle a long hallway that seems to stretch endlessly in either direction.  It is reminiscent of the halls that one might see in a fancy hotel; identical doors are spaced regularly along the walls on either side, each of which are outfitted with a black box above the handle designed to accept a key card. The walls are papered with a rich navy and powder-blue damask pattern, and a tightly knitted carpet frames the passage, tracing muted grey and gold stripes down its length.  The air feels unnaturally still here.

A steel knife is embedded in the wall nearby.

A neat section of the blue damask wall paper has torn, revealing a patch of yellow beneath it. You admire the torn piece.

You can go north, south to the Hallway, east and west from here.

* * *

>n
You walk some distance down the length of the hallway until you arrive at the next set of adjacent doors

Hallway
This is a long hallway that seems to stretch endlessly in either direction.  It is reminiscent of the halls that one might see in a fancy hotel; identical doors are spaced regularly along the walls on either side, each of which are outfitted with a black box above the handle designed to accept a key card. The walls are papered with a rich navy and powder-blue damask pattern, and a tightly knitted carpet frames the passage, tracing muted grey and gold stripes down its length.  The air feels unnaturally still here.

You can go north to the Hallway, south to the Hallway, east and west to the Foyer from here.

>n
You walk some distance down the length of the hallway until you arrive at the next set of adjacent doors

Hallway
You are standing in the middle a long hallway that seems to stretch endlessly in either direction.  It is reminiscent of the halls that one might see in a fancy hotel; identical doors are spaced regularly along the walls on either side, each of which are outfitted with a black box above the handle designed to accept a key card. The walls are papered with a rich navy and powder-blue damask pattern, and a tightly knitted carpet frames the passage, tracing muted grey and gold stripes down its length.  The air feels unnaturally still here.

A steel knife is embedded in the wall nearby.

A neat section of the blue damask wall paper has torn, revealing a patch of yellow beneath it. You admire the torn piece.

You can go north to the Hallway, south to the Hallway, east and west from here.

* * *

>feel cell
You can't see any such thing.

>ACTIONS
Actions listing on.

>feel cell
You can't see any such thing.

>feel wall
You can't see any such thing.

>feel lighter
You can't see any such thing.

>i
[taking inventory]
You are carrying:
  a booze
  a solutions manual

[taking inventory - succeeded]

>feel booze
[touching the booze]
You feel nothing unexpected.
[touching the booze - succeeded]

* * *

>feel
What do you want to feel?

>ACTIONS
Actions listing on.

>feel
You must supply a noun.

>feel cell
You can't see any such thing.

>look
[looking]
Darkness
It is pitch dark, and you can't see a thing.

You can see no obvious exits.

[looking - succeeded]

>sense
That's not a verb I recognise.

* * *

>feel
What do you want to feel?

>feel nothing
You can't see any such thing.

>ACTIONS
Actions listing on.

>feel nothing
You can't see any such thing.

>feel lighter
You can't see any such thing.

>feel booze
[touching the booze]
You feel nothing unexpected.
[touching the booze - succeeded]

* * *

>examine glasses
It is a pair of half-moon spectacles with red frames. They glow faintly.

* * *

>wear glasses
(first taking the pair of glasses)
You put on the pair of glasses.

>examine books
You peruse the book titles. None of them stand out to you.

>look
Ordinary Room
This is a very plain room about 14 foot square. The walls are white.

You can see a short bookcase (on which is a row of books) here.

You can see no obvious exits.

>ACTIONS
Actions listing on.

>look
[looking]
Ordinary Room
This is a very plain room about 14 foot square. The walls are white.

You can see a short bookcase (on which is a row of books) here.

You can see no obvious exits.

[looking - succeeded]

>i
[taking inventory]
You are carrying:
  a pair of glasses (being worn)
  a booze
  a solutions manual

[taking inventory - succeeded]

* * *

>wear glasses
(first taking the pair of glasses)
You put on the pair of glasses.

>look
Ordinary Room
This is a very plain room about 14 foot square. The walls are white.

You can see a short bookcase (on which is a row of books) here.

You can see no obvious exits.

>take book
You peruse the book titles. None of them stand out to you, so you decide to leave them alone.

>take red book
You can't see any such thing.

* * *

>take book
You peruse the book titles. None of them stand out to you, so you decide to leave them alone.

>read book
The first page says: "YOU ARE READING THIS BOOK."

>drop book
The next page says: "YOU ARE STILL READING THIS BOOK."

>stop
That's not a verb I recognise.

>stop reading
That's not a verb I recognise.

>look
The next page says: "YOU WILL CONTINUE READING THIS BOOK."

>wait
The next page says: "YOU ARE STILL READING THIS BOOK."

>wait
The next page says: "YOU WILL CONTINUE READING THIS BOOK."All this reading is making you tried.

>wait
The next page says: "YOU WILL CONTINUE READING THIS BOOK."You feel drained. It's getting harder to understand the words.

>wait
The next page says: "YOU WILL CONTINUE READING THIS BOOK."You're exhausted. It's getting hard to think of anything at all.

>wait
The next page says: "YOU WILL CONTINUE READING THIS BOOK."You feel as if you might pass out soon.

>wait
The next page says: "YOU WILL CONTINUE READING THIS BOOK."The next page says: "YOU HAVE FINISHED..."The book drops from your hand as you fall asleep mid-sentence, sinking into warm darkness. Time passes, and you awake lying face-down on the carpet in an unfamiliar hallway. There is something strange about this place, but you can't quite explain it. You also sense that something important has changed. You feel a vague but persistent tension growing in the back of your mind. You slowly stand, and after a brief dizzy spell, regain your footing,

* * *

>take book
You peruse the book titles. None of them stand out to you, so you decide to leave them alone.

>look
Ordinary Room
This is a very plain room about 14 foot square. The walls are white.

You can see a short bookcase (on which is a row of books) here.

You can see no obvious exits.

>read book
You'd rather not.

>look
Ordinary Room
This is a very plain room about 14 foot square. The walls are white.

You can see a short bookcase (on which is a row of books) here.

You can see no obvious exits.

>examine book
It is a hardcover book. The title is "You Will Read This Book".

>read book
The first page says: "YOU ARE READING THIS BOOK."

>wai
That's not a verb I recognise.

>wait
The next page says: "YOU ARE STILL READING THIS BOOK."

* * *

>look
Ordinary Room
This is a very plain room about 14 foot square. The walls are white.

You can see a short bookcase (on which is a row of books) here.

You can see no obvious exits.

>wear glasses
You're already wearing that!

>read bok
You can't see any such thing.

>look
Everything is out of focus except for a single red book on the bookcase

>read book
The first page says: "YOU ARE READING THIS BOOK."

* * *

>wait
The next page says: "YOU WILL CONTINUE READING THIS BOOK."

>wait
The next page says: "YOU WILL CONTINUE READING THIS BOOK."
All this reading is making you tried.

>wait
The next page says: "YOU WILL CONTINUE READING THIS BOOK."
You feel drained. It's getting harder to understand the words.

>wait
The next page says: "YOU WILL CONTINUE READING THIS BOOK."
You're exhausted. It's getting hard to think of anything at all.

>wait
The next page says: "YOU WILL CONTINUE READING THIS BOOK."
You feel as if you might pass out soon.

>wait
The next page says: "YOU WILL CONTINUE READING THIS BOOK."
The next page says: "YOU HAVE FINISHED..."
The book drops from your hand as you fall asleep mid-sentence, sinking into warm darkness. Time passes, and you awake lying face-down on the carpet in an unfamiliar hallway. There is something strange about this place, but you can't quite explain it. You also sense that something important has changed. You feel a vague but persistent tension growing in the back of your mind. You slowly stand, and after a brief dizzy spell, regain your footing,

>wait
The next page says: "YOU WILL CONTINUE READING THIS BOOK."

* * *

>wait
Time passes.

* * *

>look
Ordinary Room
This is a very plain room about 14 foot square. The walls are white.

You can see a short bookcase (on which is a row of books) here.

You can see no obvious exits.

>read book
The first page says: "YOU ARE READING THIS BOOK."

* * *

>wait
The next page says: "YOU ARE STILL READING THIS BOOK."
You feel drained. It's getting harder to understand the words.

>wait
The next page says: "YOU ARE STILL READING THIS BOOK."
You're exhausted. It's getting hard to think of anything at all.

>wait
The next page says: "YOU ARE STILL READING THIS BOOK."
You feel as if you might pass out soon.

>wait
The next page says: "YOU ARE STILL READING THIS BOOK."
The book drops from your hand as you fall asleep mid-sentence, sinking into warm darkness. Time passes, and you awake lying face-down on the carpet in an unfamiliar hallway. There is something strange about this place, but you can't quite explain it. You also sense that something important has changed. You feel a vague but persistent tension growing in the back of your mind. You slowly stand, and after a brief dizzy spell, regain your footing,

>wait
The next page says: "YOU HAVE FINISHED..."
The book drops from your hand as you fall asleep mid-sentence, sinking into warm darkness. Time passes, and you awake lying face-down on the carpet in an unfamiliar hallway. There is something strange about this place, but you can't quite explain it. You also sense that something important has changed. You feel a vague but persistent tension growing in the back of your mind. You slowly stand, and after a brief dizzy spell, regain your footing,

The next page says: "YOU HAVE FINISHED..."
Time passes.

>wait
Time passes.

>wait
The next page says: "YOU HAVE FINISHED..."

>wait
The next page says: "YOU HAVE FINISHED..."

* * *

>where am I?
That's not a verb I recognise.

* * *

>what the fuck
That's not a verb I recognise.

* * *

>l
The next page says: "YOU ARE STILL READING THIS BOOK."

>l
The next page says: "YOU ARE STILL READING THIS BOOK."
All this reading is making you tried.

>l
The next page says: "YOU ARE STILL READING THIS BOOK."
The more you read, the more tired you feel.

>l
The next page says: "YOU ARE STILL READING THIS BOOK."
You feel drained. It's getting harder to understand the words.

>l
The next page says: "YOU ARE STILL READING THIS BOOK."
You're exhausted. It's getting hard to think of anything at all.

* * *

>l
The next page says: "YOU ARE STILL READING THIS BOOK."
You feel as if you might pass out soon.

>l
The next page says: "YOU ARE STILL READING THIS BOOK."
The book drops from your hand as you fall asleep mid-sentence, sinking into warm darkness. Time passes, and you awake lying face-down on the carpet in an unfamiliar hallway. There is something strange about this place, but you can't quite explain it. You also sense that something important has changed. You feel a vague but persistent tension growing in the back of your mind. You slowly stand, and after a brief dizzy spell, regain your footing,

>l
The next page says: "YOU HAVE FINISHED..."
The book drops from your hand as you fall asleep mid-sentence, sinking into warm darkness. Time passes, and you awake lying face-down on the carpet in an unfamiliar hallway. There is something strange about this place, but you can't quite explain it. You also sense that something important has changed. You feel a vague but persistent tension growing in the back of your mind. You slowly stand, and after a brief dizzy spell, regain your footing,

>l
The next page says: "YOU HAVE FINISHED..."

* * *

>wear glasses
(first taking the pair of glasses)
You put on the pair of glasses.

>take book
You peruse the book titles. None of them stand out to you, so you decide to leave them alone.

>look
Everything is out of focus, except for a single red book on the bookcase

>take book
Taken.

>read book
The first page says: "YOU ARE READING THIS BOOK."

>read second page of book
You can't see any such thing.

>read page 2 of book
You'd rather not.

* * *

>l
The next page says: "YOU ARE STILL READING THIS BOOK."

>wait
The next page says: "YOU ARE STILL READING THIS BOOK."

>run
You'll have to say which compass direction to go in.

>w
The next page says: "YOU ARE STILL READING THIS BOOK."

* * *

>take book
You peruse the book titles. None of them stand out to you, so you decide to leave them alone.

>read book
You'd rather not.

>l
Everything is out of focus, except for a single red book on the bookcase

>take book
Taken.

* * *

>l
The next page says: "YOU ARE STILL READING THIS BOOK."
You feel as if you might pass out soon.

>l
Everything is out of focus. You can barely see.

The next page says: "YOU HAVE FINISHED..." 
The book drops from your hand as you fall asleep mid-sentence, sinking into warm darkness. Time passes, and you awake lying face-down on the carpet in an unfamiliar hallway. There is something strange about this place, but you can't quite explain it. You also sense that something important has changed. You feel a vague but persistent tension growing in the back of your mind. You slowly stand, and after a brief dizzy spell, regain your footing,

>l
Everything is out of focus. You can barely see.

* * *

>read book
The first page says: "YOU ARE READING THIS BOOK."

>look
Everything is out of focus, except for a single red book on the bookcase

* * *

>wait
The next page says: "YOU ARE STILL READING THIS BOOK."

>wait
test

* * *

>l
The next page says: "YOU ARE STILL READING THIS BOOK."

>read book
The first page says: "YOU ARE READING THIS BOOK."

* * *

>look
Everything is out of focus except for a single red book on the bookcase

>take off glasses
You take off the pair of glasses.

>l
Ordinary Room
This is a very plain room about 14 foot square. The walls are white.

You can see a short bookcase (on which is a red book) here.

You can see no obvious exits.

* * *

>l
The next page says: "YOU ARE STILL READING THIS BOOK."

>take book
Everything is out of focus except for a single red book on the bookcase

>read book
The first page says: "YOU ARE READING THIS BOOK."

* * *

>l
The next page says: "YOU ARE STILL READING THIS BOOK."
You feel as if you might pass out soon.

>l
The next page says: "YOU ARE STILL READING THIS BOOK."
The next page says: "YOU ARE STILL READING THIS BOOK." 
You feel as if you might pass out soon.

>l
Everything is out of focus. You can barely see.

>l
Everything is out of focus. You can barely see.

* * *

>s
...you walk some distance down the length of the hallway until you arrive at the next set of adjacent doors...

Hallway
You are standing in the middle a long hallway that seems to stretch endlessly in either direction.  It is reminiscent of the halls that one might see in a fancy hotel; identical doors are spaced regularly along the walls on either side, each of which are outfitted with a black box above the handle designed to accept a key card. The walls are papered with a rich navy and powder-blue damask pattern, and a tightly knitted carpet frames the passage, tracing muted grey and gold stripes down its length.  The air feels unnaturally still here.

You can go north, south, east and west from here.

* * *

>w
Narrow Corridor
This narrow corridor branches off of the main hallway. There is a door to the west that looks slightly different from the others. The wood is richer and brighter, and it opens outward rather than inward. A brass plaque is posted on the wall next to it.

You can see an unusual door and a brass plaque here.

You can go east to the Hallway and west through the unusual door (closed) from here.

>e
Hallway
You are in the main hallway. It stretches indefinitely in either direction. There are doors to your east and west.

* * *

>look
Hallway
Hallway
You are in the main hallway. It stretches indefinitely in either direction. There are doors to your east and west.

You can go north, south to the Hallway, east and west from here.

* * *

>l
You are in the main hallway. It stretches indefinitely in either direction. There are doors to your east and west.

* * *

>l
Hallway
This is a long hallway that seems to stretch endlessly in either direction.  It is reminiscent of the halls of a fancy hotel; identical doors are spaced regularly along the walls on either side, each of which are outfitted with a black box above the handle designed to accept a key card. The walls are papered with a rich navy and powder-blue damask pattern, and a tightly knitted carpet frames the passage, tracing muted grey and gold stripes down its length. The air feels unnaturally still 

You can go north, south, east and west from here.

>s
...you walk some distance down the length of the hallway until you arrive at the next set of adjacent doors...

Hallway
You are standing in the middle a long hallway that seems to stretch endlessly in either direction.  It is reminiscent of the halls that one might see in a fancy hotel; identical doors are spaced regularly along the walls on either side, each of which are outfitted with a black box above the handle designed to accept a key card. The walls are papered with a rich navy and powder-blue damask pattern, and a tightly knitted carpet frames the passage, tracing muted grey and gold stripes down its length.  The air feels unnaturally still here.

You can go north to the Hallway, south, east and west from here.

>n
...you walk some distance down the length of the hallway until you arrive at the next set of adjacent doors...

You are in the main hallway. It stretches indefinitely in either direction. There are doors to your east and west.
The obvious exits are north, south (to the hallway), east and west.

>look
Hallway
This is a long hallway that seems to stretch endlessly in either direction.  It is reminiscent of the halls of a fancy hotel; identical doors are spaced regularly along the walls on either side, each of which are outfitted with a black box above the handle designed to accept a key card. The walls are papered with a rich navy and powder-blue damask pattern, and a tightly knitted carpet frames the passage, tracing muted grey and gold stripes down its length. The air feels unnaturally still 

You can go north, south to the Hallway, east and west from here.

* * *

>e
Records Room
This is an austere looking room with beige tile floors below and white flourescent lighting overhead. A number of file cabinets line the north and south walls. In the furthest corner is a grey metal desk with two locking drawers and a bankers lamp with a green glass shade. It is uncomfortably warm in here. In the corner, a standing metal fan is noisily failing to cool it.

You can see a metal fan and some file cabinets here.

You can go east and west from here.

>read book
The first page says: "YOU ARE READING THIS BOOK."

>l
The next page says: "YOU HAVE FINISHED..." 
The book drops from your hand as you fall asleep mid-sentence, sinking into warm darkness. Time passes, and you awake lying face-down on the carpet in an unfamiliar hallway. There is something strange about this place, but you can't quite explain it. You also sense that something important has changed. You feel a vague but persistent tension growing in the back of your mind. You slowly stand, and after a brief dizzy spell, regain your footing.

Hallway
This is a long hallway that seems to stretch endlessly in either direction.  It is reminiscent of the halls of a fancy hotel; identical doors are spaced regularly along the walls on either side, each of which are outfitted with a black box above the handle designed to accept a key card. The walls are papered with a rich navy and powder-blue damask pattern, and a tightly knitted carpet frames the passage, tracing muted grey and gold stripes down its length. The air feels unnaturally still 
The obvious exits are north, south, east (to the records room) and west.

* * *

>l
The next page says: "YOU ARE STILL READING THIS BOOK."

I beg your pardon?

>ll
That's not a verb I recognise.

>l
The next page says: "YOU ARE STILL READING THIS BOOK."

* * *

>l
The next page says: "YOU ARE STILL READING THIS BOOK."

You feel as if you might pass out soon.

>l
The next page says: "YOU HAVE FINISHED..." 
The book drops from your hand as you fall asleep mid-sentence, sinking into warm darkness. Time passes, and you awake lying face-down on the carpet in an unfamiliar hallway. There is something strange about this place, but you can't quite explain it. You also sense that something important has changed. You feel a vague but persistent tension growing in the back of your mind. You slowly stand, and after a brief dizzy spell, regain your footing.

Hallway
This is a long hallway that seems to stretch endlessly in either direction.  It is reminiscent of the halls of a fancy hotel; identical doors are spaced regularly along the walls on either side, each of which are outfitted with a black box above the handle designed to accept a key card. The walls are papered with a rich navy and powder-blue damask pattern, and a tightly knitted carpet frames the passage, tracing muted grey and gold stripes down its length. The air feels unnaturally still This is a long hallway that seems to stretch endlessly in either direction.  It is reminiscent of the halls of a fancy hotel; identical doors are spaced regularly along the walls on either side, each of which are outfitted with a black box above the handle designed to accept a key card. The walls are papered with a rich navy and powder-blue damask pattern, and a tightly knitted carpet frames the passage, tracing muted grey and gold stripes down its length. The air feels unnaturally still 

You can go north, south, east and west from here.

>e
Records Room
This is an austere looking room with beige tile floors below and white flourescent lighting overhead. A number of file cabinets line the north and south walls. In the furthest corner is a grey metal desk with two locking drawers and a bankers lamp with a green glass shade. It is uncomfortably warm in here. In the corner, a standing metal fan is noisily failing to cool it.

You can see a metal fan and some file cabinets here.

You can go east and west to the Hallway from here.

>w
Hallway
This is a long hallway that seems to stretch endlessly in either direction.  It is reminiscent of the halls of a fancy hotel; identical doors are spaced regularly along the walls on either side, each of which are outfitted with a black box above the handle designed to accept a key card. The walls are papered with a rich navy and powder-blue damask pattern, and a tightly knitted carpet frames the passage, tracing muted grey and gold stripes down its length. The air feels unnaturally still This is a long hallway that seems to stretch endlessly in either direction.  It is reminiscent of the halls of a fancy hotel; identical doors are spaced regularly along the walls on either side, each of which are outfitted with a black box above the handle designed to accept a key card. The walls are papered with a rich navy and powder-blue damask pattern, and a tightly knitted carpet frames the passage, tracing muted grey and gold stripes down its length. The air feels unnaturally still 

You can go north, south, east to the Records Room and west from here.

>w
Narrow Corridor
This narrow corridor branches off of the main hallway. There is a door to the west that looks slightly different from the others. The wood is richer and brighter, and it opens outward rather than inward. A brass plaque is posted on the wall next to it.

You can see an unusual door and a brass plaque here.

You can go east to the Hallway and west through the unusual door (closed) from here.

* * *

>e
Hallway
You are in the main hallway. It stretches indefinitely in either direction. There are doors to your east and west.

>n
...you walk some distance down the length of the hallway until you arrive at the next set of adjacent doors...

Hallway
You are in the main hallway. It stretches indefinitely in either direction. There are doors to your east and west.

>w
Foyer
Despite being an isolated room in the middle of a hallway, this room appears to be a foyer. There is a small sofa and a shoe rack along the west wall. On the north wall, there is a clock. There is a staircase in the northwest corner leading down. The bottom of the stairs is in darkness, but you think you percieve the vague outline of a person there.

You can see a shoe rack (on which is a pair of women's heels) here.

You can go northwest and east from here.

>e
Hallway
You are in the main hallway. It stretches indefinitely in either direction. There are doors to your east and west.

>e
Place Where you Shouldn't Be
This is a square room with little ornamentation. You feel as if you shouldn't be here.

You can see a black door here.

You can go north through the black door (closed) and west from here.

>w
Hallway
You are in the main hallway. It stretches indefinitely in either direction. There are doors to your east and west.

>n
...you walk some distance down the length of the hallway until you arrive at the next set of adjacent doors...

Hallway
You are in the main hallway. It stretches indefinitely in either direction. There are doors to your east and west.

* * *

>w
Bedroom
This looks like a child's bedroom.

There is a framed text on the wall. It looks like a nursery rhyme.

Against the far wall is a small white nightstand with a single drawer.

On the nightstand is an ornamental box.

You can also see a wardrobe and a cabinet here.

You can go east from here.

>e
Hallway
You are in the main hallway. It stretches indefinitely in either direction. There are doors to your east and west.

>e
Drinking Room
This room is fully furnished including a white fainting couch, a grandfather clock, and a coffee table. All of the furniture is made of the same dark, rich wood that can be found throughout. On the wall there is a full-sized mirror and a large painting of a woman. In the northeast corner you can see a small metal gate stretched across a doorway. You think you can hear a faint ticking sound.

There is a fully stocked bar in the corner. It is has a beautiful curved countertop and many shelves of liquors which reach to the cieling behind it. Almost all of the bottles are brand new and sealed.

On the bar are a bottle of whiskey, a bottle of vodka, a bottle of gin and a lemon.

You can see a grandfather clock here.

You can also see a metal gate here.

You can go northeast through the metal gate (closed) and west from here.

>w
Hallway
You are in the main hallway. It stretches indefinitely in either direction. There are doors to your east and west.

* * *

>n
...you walk some distance down the length of the hallway until you arrive at the next set of adjacent doors...

Hallway
You are in the main hallway. It stretches indefinitely in either direction. There are doors to your east and west.

>w
Old Mall
The hallway opens up into what appears to be an empty shopping mall. There is a high domed cieling with skylights overhead. The floor transitions from the carpeted hallway to over-large tan octagonal tiles. They air is cool here and slightly more humid, as if there were a water source nearby. You think you may even hear the distant trickle of water. A few small trees can be seen in planters, spaced decoratively. In contrast to the tense and silent hallway, this space is pleasant and serene. You can see the entrance to several shops. The Ordinary Shop is to the northeast, the Extraordinary Shop is to the northwest, and The Lonely and Dark stores are to the east and west respectively. There is also an escalator leading up to a second floor.

You can go north, south, southwest, east, west and up from here.

>sw
Darkness
It is dark here.

You see nothing but the darkness.

You can go northeast to the Old Mall from here.

* * *

>take key
As you take the key, you are breifly overcome by a wave of vertigo. A knot forms in your stomach, and you have the terrible feeling that you have taken something which does not belong to you.

>e
You can't go that way.

* * *

>w
You can't go that way.

>l
Darkness
It is dark here.

You see nothing but the darkness.

You can go northeast to the Old Mall from here.

>ne
Old Mall
The hallway opens up into what appears to be an empty shopping mall. There is a high domed cieling with skylights overhead. The floor transitions from the carpeted hallway to over-large tan octagonal tiles. They air is cool here and slightly more humid, as if there were a water source nearby. You think you may even hear the distant trickle of water. A few small trees can be seen in planters, spaced decoratively. In contrast to the tense and silent hallway, this space is pleasant and serene. You can see the entrance to several shops. The Ordinary Shop is to the northeast, the Extraordinary Shop is to the northwest, and The Lonely and Dark stores are to the east and west respectively. There is also an escalator leading up to a second floor.

You can go north, south, southwest to the Darkness, east, west and up from here.

>e
Hallway
You are in the main hallway. It stretches indefinitely in either direction. There are doors to your east and west.

* * *

>n
...you walk some distance down the length of the hallway until you arrive at the next set of adjacent doors...

Hallway
You are in the main hallway. It stretches indefinitely in either direction. There are doors to your east and west.

>n
...you walk some distance down the length of the hallway until you arrive at the next set of adjacent doors...

Hallway
You are in the main hallway. It stretches indefinitely in either direction. There are doors to your east and west.

>w
Empty Corridor
This is a long section of empty hallway. Further west, you see that the hallway diverges into similar looking corridors with no doors, no furniture and no ornamentation. You sense that if you keep going to the west, you may become lost. The wallpaper is yellow here.

You can go east and west from here.

>e
Hallway
You are in the main hallway. It stretches indefinitely in either direction. There are doors to your east and west.

>e
Outside Room
Opening the door reveals what at first looks to be a wide outdoor space filled with shrubs and grasses. A fog hangs in the air above you, obscuring the view upward. The illusion is broken by many white pillars holding up what must be a distant cieling. In the east corner of this large room is a small plastic house.

You can go east and west from here.

>w
Hallway
You are in the main hallway. It stretches indefinitely in either direction. There are doors to your east and west.

>e
Outside Room
Opening the door reveals what at first looks to be a wide outdoor space filled with shrubs and grasses. A fog hangs in the air above you, obscuring the view upward. The illusion is broken by many white pillars holding up what must be a distant cieling. In the east corner of this large room is a small plastic house.

You can go east and west from here.

>e
Play House
This house would be very cozy if it weren't sized for children. There is a kitchenette complete with a table, plastic stove and refrigerator, and a living room which contains a chair, a small throw rug, and a well-drawn picture of a television. There are many clocks drawn on the walls in crayon, each telling different times.

A little plastic stove that opens and closes.

A plastic refrigerator that opens and closes.

You can also see a table (on which is a plastic toaster) here.

You can go west to the Outside Room from here.

>w
Outside Room
Opening the door reveals what at first looks to be a wide outdoor space filled with shrubs and grasses. A fog hangs in the air above you, obscuring the view upward. The illusion is broken by many white pillars holding up what must be a distant cieling. In the east corner of this large room is a small plastic house.

You can go east to the Play House and west from here.

>e
Play House
This house would be very cozy if it weren't sized for children. There is a kitchenette complete with a table, plastic stove and refrigerator, and a living room which contains a chair, a small throw rug, and a well-drawn picture of a television. There are many clocks drawn on the walls in crayon, each telling different times.

A little plastic stove that opens and closes.

A plastic refrigerator that opens and closes.

You can also see a table (on which is a plastic toaster) here.

You can go west to the Outside Room from here.

* * *

>w
Outside Room
Opening the door reveals what at first looks to be a wide outdoor space filled with shrubs and grasses. A fog hangs in the air above you, obscuring the view upward. The illusion is broken by many white pillars holding up what must be a distant cieling. In the east corner of this large room is a small plastic house.

You can go east to the Play House and west from here.

>w
Hallway
You are in the main hallway. It stretches indefinitely in either direction. There are doors to your east and west.

>l
Hallway
You are standing in the middle a long hallway that seems to stretch endlessly in either direction.  It is reminiscent of the halls that one might see in a fancy hotel; identical doors are spaced regularly along the walls on either side, each of which are outfitted with a black box above the handle designed to accept a key card. The walls are papered with a rich navy and powder-blue damask pattern, and a tightly knitted carpet frames the passage, tracing muted grey and gold stripes down its length.  The air feels unnaturally still here.

You can go north to the Hallway, south, east to the Outside Room and west to the Empty Corridor from here.

>n
...you walk some distance down the length of the hallway until you arrive at the next set of adjacent doors...

Hallway
You are in the main hallway. It stretches indefinitely in either direction. There are doors to your east and west.

>e
Records Room
This is an austere looking room with beige tile floors below and white flourescent lighting overhead. A number of file cabinets line the north and south walls. In the furthest corner is a grey metal desk with two locking drawers and a bankers lamp with a green glass shade. It is uncomfortably warm in here. In the corner, a standing metal fan is noisily failing to cool it.

You can see a metal fan and some file cabinets here.

You can go east and west to the Hallway from here.

>w
Hallway
You are in the main hallway. It stretches indefinitely in either direction. There are doors to your east and west.

>w
Narrow Corridor
This narrow corridor branches off of the main hallway. There is a door to the west that looks slightly different from the others. The wood is richer and brighter, and it opens outward rather than inward. A brass plaque is posted on the wall next to it.

You can see an unusual door and a brass plaque here.

You can go east to the Hallway and west through the unusual door (closed) from here.

* * *

>n
...you walk some distance down the length of the hallway until you arrive at the next set of adjacent doors...

Hallway
You are in the main hallway. It stretches indefinitely in either direction. There are doors to your east and west.

>s
...you walk some distance down the length of the hallway until you arrive at the next set of adjacent doors...

Hallway
You are in the main hallway. It stretches indefinitely in either direction. There are doors to your east and west.

>l
Hallway
This is a long hallway that seems to stretch endlessly in either direction.  It is reminiscent of the halls of a fancy hotel; identical doors are spaced regularly along the walls on either side, each of which are outfitted with a black box above the handle designed to accept a key card. The walls are papered with a rich navy and powder-blue damask pattern, and a tightly knitted carpet frames the passage, tracing muted grey and gold stripes down its length. The air feels unnaturally still This is a long hallway that seems to stretch endlessly in either direction.  It is reminiscent of the halls of a fancy hotel; identical doors are spaced regularly along the walls on either side, each of which are outfitted with a black box above the handle designed to accept a key card. The walls are papered with a rich navy and powder-blue damask pattern, and a tightly knitted carpet frames the passage, tracing muted grey and gold stripes down its length. The air feels unnaturally still 

You can go north, south to the Hallway, east to the Records Room and west to the Narrow Corridor from here.

* * *

>read book
The first page says: "YOU ARE READING THIS BOOK."

>read book
The first page says: "YOU ARE READING THIS BOOK."

* * *

I beg your pardon?

>l
The next page says: "YOU ARE STILL READING THIS BOOK."

* * *

>l
The next page says: "YOU ARE STILL READING THIS BOOK."
You feel as if you might pass out soon.

>l
Hallway
This is a long hallway that seems to stretch endlessly in either direction.  It is reminiscent of the halls of a fancy hotel; identical doors are spaced regularly along the walls on either side, each of which are outfitted with a black box above the handle designed to accept a key card. The walls are papered with a rich navy and powder-blue damask pattern, and a tightly knitted carpet frames the passage, tracing muted grey and gold stripes down its length. The air feels unnaturally still This is a long hallway that seems to stretch endlessly in either direction.  It is reminiscent of the halls of a fancy hotel; identical doors are spaced regularly along the walls on either side, each of which are outfitted with a black box above the handle designed to accept a key card. The walls are papered with a rich navy and powder-blue damask pattern, and a tightly knitted carpet frames the passage, tracing muted grey and gold stripes down its length. The air feels unnaturally still 

You can go north, south, east and west from here.

The next page says: "YOU HAVE FINISHED..." 
The book drops from your hand as you fall asleep mid-sentence, sinking into warm darkness. Time passes, and you awake lying face-down on the carpet in an unfamiliar hallway. There is something strange about this place, but you can't quite explain it. You also sense that something important has changed. You feel a vague but persistent tension growing in the back of your mind. You slowly stand, and after a brief dizzy spell, regain your footing,

* * *

>read book
The first page says: "YOU ARE READING THIS BOOK."

>ll
That's not a verb I recognise.

I beg your pardon?

* * *

>l
The next page says: "YOU ARE STILL READING THIS BOOK."

You feel as if you might pass out soon.

>l
The next page says: "YOU HAVE FINISHED..." 
The book drops from your hand as you fall asleep mid-sentence, sinking into warm darkness. Time passes, and you awake lying face-down on the carpet in an unfamiliar hallway. There is something strange about this place, but you can't quite explain it. You also sense that something important has changed. You feel a vague but persistent tension growing in the back of your mind. You slowly stand, and after a brief dizzy spell, regain your footing.

Hallway
This is a long hallway that seems to stretch endlessly in either direction.  It is reminiscent of the halls of a fancy hotel; identical doors are spaced regularly along the walls on either side, each of which are outfitted with a black box above the handle designed to accept a key card. The walls are papered with a rich navy and powder-blue damask pattern, and a tightly knitted carpet frames the passage, tracing muted grey and gold stripes down its length. The air feels unnaturally still 

You can go north, south, east and west from here.

>ls
That's not a verb I recognise.

>s
...you walk some distance down the length of the hallway until you arrive at the next set of adjacent doors...

Hallway
You are standing in the middle a long hallway that seems to stretch endlessly in either direction.  It is reminiscent of the halls that one might see in a fancy hotel; identical doors are spaced regularly along the walls on either side, each of which are outfitted with a black box above the handle designed to accept a key card. The walls are papered with a rich navy and powder-blue damask pattern, and a tightly knitted carpet frames the passage, tracing muted grey and gold stripes down its length.  The air feels unnaturally still here.

You can go north to the Hallway, south, east and west from here.

>n
...you walk some distance down the length of the hallway until you arrive at the next set of adjacent doors...

You are in the main hallway. It stretches indefinitely in either direction. There are doors to your east and west.

Hallway
This is a long hallway that seems to stretch endlessly in either direction.  It is reminiscent of the halls of a fancy hotel; identical doors are spaced regularly along the walls on either side, each of which are outfitted with a black box above the handle designed to accept a key card. The walls are papered with a rich navy and powder-blue damask pattern, and a tightly knitted carpet frames the passage, tracing muted grey and gold stripes down its length. The air feels unnaturally still 

You can go north, south to the Hallway, east and west from here.

>s
...you walk some distance down the length of the hallway until you arrive at the next set of adjacent doors...

You are in the main hallway. It stretches indefinitely in either direction. There are doors to your east and west.

Hallway
You are standing in the middle a long hallway that seems to stretch endlessly in either direction.  It is reminiscent of the halls that one might see in a fancy hotel; identical doors are spaced regularly along the walls on either side, each of which are outfitted with a black box above the handle designed to accept a key card. The walls are papered with a rich navy and powder-blue damask pattern, and a tightly knitted carpet frames the passage, tracing muted grey and gold stripes down its length.  The air feels unnaturally still here.

You can go north to the Hallway, south, east and west from here.

>n
...you walk some distance down the length of the hallway until you arrive at the next set of adjacent doors...

You are in the main hallway. It stretches indefinitely in either direction. There are doors to your east and west.

Hallway
This is a long hallway that seems to stretch endlessly in either direction.  It is reminiscent of the halls of a fancy hotel; identical doors are spaced regularly along the walls on either side, each of which are outfitted with a black box above the handle designed to accept a key card. The walls are papered with a rich navy and powder-blue damask pattern, and a tightly knitted carpet frames the passage, tracing muted grey and gold stripes down its length. The air feels unnaturally still 

You can go north, south to the Hallway, east and west from here.

* * *

>wear glasses
(first taking the pair of glasses)
You put on the pair of glasses.

>red book
That's not a verb I recognise.

>wait
Time passes.

>look
Everything is out of focus, except for a single red book on the bookcase

* * *

>wear glasses
(first taking the pair of glasses)
You put on the pair of glasses.

>l
Everything is out of focus, except for a single red book on the bookcase

>read book
The first page says: "YOU ARE READING THIS BOOK."

* * *

>l
Everything is out of focus. You can barely see.

>take off glasses
You take off the pair of glasses.

>l
Hallway
This is a long hallway that seems to stretch endlessly in either direction.  It is reminiscent of the halls of a fancy hotel; identical doors are spaced regularly along the walls on either side, each of which are outfitted with a black box above the handle designed to accept a key card. The walls are papered with a rich navy and powder-blue damask pattern, and a tightly knitted carpet frames the passage, tracing muted grey and gold stripes down its length. The air feels unnaturally still This is a long hallway that seems to stretch endlessly in either direction.  It is reminiscent of the halls of a fancy hotel; identical doors are spaced regularly along the walls on either side, each of which are outfitted with a black box above the handle designed to accept a key card. The walls are papered with a rich navy and powder-blue damask pattern, and a tightly knitted carpet frames the passage, tracing muted grey and gold stripes down its length. The air feels unnaturally still 

You can go north, south, east and west from here.

* * *

>look
Everything is out of focus. You can barely see.

* * *

>w
Narrow Corridor
This narrow corridor branches off of the main hallway. There is a door to the west that looks slightly different from the others. The wood is richer and brighter, and it opens outward rather than inward. A brass plaque is posted on the wall next to it.

You can see an unusual door and a brass plaque here.

You can go east and west through the unusual door (closed) from here.

>n
You can't go that way.

>e
Hallway
This is a long hallway that seems to stretch endlessly in either direction.  It is reminiscent of the halls of a fancy hotel; identical doors are spaced regularly along the walls on either side, each of which are outfitted with a black box above the handle designed to accept a key card. The walls are papered with a rich navy and powder-blue damask pattern, and a tightly knitted carpet frames the passage, tracing muted grey and gold stripes down its length. The air feels unnaturally still This is a long hallway that seems to stretch endlessly in either direction.  It is reminiscent of the halls of a fancy hotel; identical doors are spaced regularly along the walls on either side, each of which are outfitted with a black box above the handle designed to accept a key card. The walls are papered with a rich navy and powder-blue damask pattern, and a tightly knitted carpet frames the passage, tracing muted grey and gold stripes down its length. The air feels unnaturally still 

You can go north, south, east and west to the Narrow Corridor from here.

* * *

>look
Everything is out of focus. You can barely see.

>take off glasses
You take off the pair of glasses.

>look
Hallway
This is a long hallway that seems to stretch endlessly in either direction.  It is reminiscent of the halls of a fancy hotel; identical doors are spaced regularly along the walls on either side, each of which are outfitted with a black box above the handle designed to accept a key card. The walls are papered with a rich navy and powder-blue damask pattern, and a tightly knitted carpet frames the passage, tracing muted grey and gold stripes down its length. The air feels unnaturally still This is a long hallway that seems to stretch endlessly in either direction.  It is reminiscent of the halls of a fancy hotel; identical doors are spaced regularly along the walls on either side, each of which are outfitted with a black box above the handle designed to accept a key card. The walls are papered with a rich navy and powder-blue damask pattern, and a tightly knitted carpet frames the passage, tracing muted grey and gold stripes down its length. The air feels unnaturally still 

You can go north, south, east and west from here.

* * *

>l
The next page says: "YOU ARE STILL READING THIS BOOK."
The more you read, the more tired you feel.

I beg your pardon?

>l
The next page says: "YOU ARE STILL READING THIS BOOK."
You feel drained. It's getting harder to understand the words.

* * *

>examine books
You peruse the book titles. None of them stand out to you.

>take books
None of them stand out to you.

* * *

>examine books
You peruse the book titles. None of them stand out to you.

>take book
You can't see any such thing.

* * *

>examine books
You peruse the book titles. None of them stand out to you.

>put on glasses
(first taking the pair of glasses)
You put on the pair of glasses.

>examine books
You peruse the book titles. None of them stand out to you.

* * *

>take book
You can't see any such thing.

>examine book
You see nothing special about the books.

* * *

>take book
You can't see any such thing.

>examine books
You can't see any such thing.

* * *

>take books
You peruse the book titles. None of them stand out to you.

>look
Ordinary Room
This is a very plain room about 14 foot square. The walls are white, and there is a short bookcase on the eastern wall.

You can see a pair of glasses and a short bookcase (on which is a dummy book) here.

You can see no obvious exits.

* * *

>take glasses
Taken.

>look
Ordinary Room
This is a very plain room about 14 foot square. The walls are white.

You can see a short bookcase (on which is a row of books) here.

You can see no obvious exits.

* * *

>read book
You'd rather not.

>wear glasses
You put on the pair of glasses.

>look
Everything is out of focus, except for a single red book on the bookcase

* * *

>take glasses
Taken.

>wear glasses
You put on the pair of glasses.

* * *

>wait
The next page says: "YOU ARE STILL READING THIS BOOK."
All this reading is making you tried.

>wait
The next page says: "YOU ARE STILL READING THIS BOOK."
You feel drained. It's getting harder to understand the words.

* * *

>wait
The next page says: "YOU ARE STILL READING THIS BOOK."
The book drops from your hand as you fall asleep mid-sentence, sinking into warm darkness. Time passes, and you awake lying face-down on the carpet in an unfamiliar hallway. There is something strange about this place, but you can't quite explain it. You also sense that something important has changed. You feel a vague but persistent tension growing in the back of your mind. You slowly stand, and after a brief dizzy spell, regain your footing,

>wait
The next page says: "YOU HAVE FINISHED..."
The book drops from your hand as you fall asleep mid-sentence, sinking into warm darkness. Time passes, and you awake lying face-down on the carpet in an unfamiliar hallway. There is something strange about this place, but you can't quite explain it. You also sense that something important has changed. You feel a vague but persistent tension growing in the back of your mind. You slowly stand, and after a brief dizzy spell, regain your footing,

>wait
Time passes.

* * *

>wear glasses
You put on the pair of glasses.

>read book
You'd rather not.

>look
Everything is out of focus, except for a single red book on the bookcase

* * *

>wait
The next page says: "YOU ARE STILL READING THIS BOOK."
The book drops from your hand as you fall asleep mid-sentence, sinking into warm darkness. Time passes, and you awake lying face-down on the carpet in an unfamiliar hallway. There is something strange about this place, but you can't quite explain it. You also sense that something important has changed. You feel a vague but persistent tension growing in the back of your mind. You slowly stand, and after a brief dizzy spell, regain your footing,

>wait
The next page says: "YOU HAVE FINISHED..."

>wait
The next page says: "YOU ARE STILL READING THIS BOOK."

* * *

>read books
You'd rather not.

>l
Ordinary Room
This is a very plain room about 14 foot square. The walls are white.

You can see a pair of glasses and a short bookcase (on which is a row of books) here.

You can see no obvious exits.

* * *

>SCREAM
Did that make you feel better?