Welcome
An Interactive Fiction
Release 1 / Serial number 200927 / Inform 7 build 6M62 (I6/v6.33 lib 6/12N) SD

Ordinary Room
You see a white book here.

>examine cand
You can't see any such thing.

* * *

Welcome
An Interactive Fiction
Release 1 / Serial number 200927 / Inform 7 build 6M62 (I6/v6.33 lib 6/12N) SD

Ordinary Room
You see a white book here.

>examine candy
It is oval in shape, wrapped with two sets of colored stripes.

* * *

Welcome
An Interactive Fiction
Release 1 / Serial number 200927 / Inform 7 build 6M62 (I6/v6.33 lib 6/12N) SD

Ordinary Room
You see a white book here.

>w
Strip Club
Neon lights flash in rhythmic pulses, augmenting the sound of booming techno music.

Your mom is standing on a broad backlit stage, naked except for a pair of leopard-print heels, dancing suggestively.

>examine mom
This is exactly the sort of behavior I would have expected from you. Bad boy!

* * *

>w
Strip Club
Neon lights flash in rhythmic pulses, augmenting the sound of booming techno music.

Your mom is standing on a broad backlit stage, naked except for a pair of leopard-print heels, dancing suggestively.

>wait
Your mom saddles up to a nearby drunk, and begins twerking agressively in his general direction.

* * *

Welcome
An Interactive Fiction
Release 1 / Serial number 200927 / Inform 7 build 6M62 (I6/v6.33 lib 6/12N) SD

Ordinary Room
You see a white book here.

I beg your pardon?

I beg your pardon?

* * *

Welcome
An Interactive Fiction
Release 1 / Serial number 200927 / Inform 7 build 6M62 (I6/v6.33 lib 6/12N) SD

Ordinary Room
You see a white book here.

>take candy
Taken.

>w
Strip Club
Neon lights flash in rhythmic pulses, augmenting the sound of booming techno music. The current song is an electronic cover of Goofy Goober.

Your mom is standing on a broad backlit stage, naked except for a pair of leopard-print heels, dancing suggestively.

>give candy to mom
You can only do that to something animate.

* * *

Welcome
An Interactive Fiction
Release 1 / Serial number 200927 / Inform 7 build 6M62 (I6/v6.33 lib 6/12N) SD

Ordinary Room
You see a white book here.

>read book
The first page says: "YOU ARE READING THIS BOOK."

>take book
Taken.

>read book
You see nothing special about the red book.

>look
Ordinary Room

>wait
Time passes.

>read book
You see nothing special about the red book.

>read book
You see nothing special about the red book.

>ACTIONS
Actions listing on.

>read book
[examining the red book]
You see nothing special about the red book.

[examining the red book - succeeded]

* * *

>read book
The first page says: "YOU ARE READING THIS BOOK."

>l
The next page says: "YOU ARE STILL READING THIS BOOK."

>l
The next page says: "YOU ARE STILL READING THIS BOOK."

>l
The next page says: "YOU ARE STILL READING THIS BOOK."

All this reading is making you tired.

>close eyes
You can't see any such thing.

* * *

>l
The next page says: "YOU ARE STILL READING THIS BOOK."

All this reading is making you tired.

>l
The next page says: "YOU CONTINUE TO READ THIS BOOK."

The more you read, the more tired you feel.

>l
The next page says: "YOU CONTINUE TO READ THIS BOOK."

You feel drained. It's getting harder to understand the words.

>l
The next page says: "YOU CONTINUE TO READ THIS BOOK."

In fact, its getting harder to think of anything at all.

>l
The next page says: "YOU CONTINUE TO READ THIS BOOK."

You're exhausted. You feel as if you might pass out soon.

>l
The next page says: "YOU HAVE FINISHED...

The book drops from your hand as you fall asleep mid-sentence, sinking into warm darkness. Time passes, and you awake lying face-down on the carpet in an unfamiliar hallway. There is something strange about this place, but you can't quite explain it. You also sense that something important has changed. You feel a vague but persistent tension growing in the back of your mind. You slowly stand, and after a brief dizzy spell, regain your footing.

Hallway

>read book
The first page says: "YOU ARE READING THIS BOOK."

I beg your pardon?

>l
The book drops from your hand as you fall asleep mid-sentence, sinking into warm darkness. Time passes, and you once again awake in the middle of the now-familiar hallway.

Hallway

* * *

>l
The next page says: "YOU CONTINUE TO READ THIS BOOK."

You're exhausted. You feel as if you might pass out soon.

>l
test
Hallway

* * *

>l
The next page says: "YOU CONTINUE TO READ THIS BOOK."

The more you read, the more tired you feel.

I beg your pardon?

>l
The next page says: "YOU CONTINUE TO READ THIS BOOK."

You feel drained. It's getting harder to understand the words.

* * *

>l
The next page says: "YOU HAVE FINISHED...

The book drops from your hand as you fall asleep mid-sentence, sinking into warm darkness. Time passes, and you awake lying face-down on the carpet in an unfamiliar hallway. There is something strange about this place, but you can't quite explain it. You also sense that something important has changed. You feel a vague but persistent tension growing in the back of your mind. You slowly stand, and after a brief dizzy spell, regain your footing.

Hallway

>l
Hallway

* * *

>l
test
Hallway

* * *

>read book
The first page says: "YOU ARE READING THIS BOOK."

>look
The next page says: "YOU ARE STILL READING THIS BOOK."

>wait
The next page says: "YOU ARE STILL READING THIS BOOK."

>what
That's not a verb I recognise.

>stop
That's not a verb I recognise.

* * *

>look
The next page says: "YOU ARE STILL READING THIS BOOK."
All this reading is making you tired.

>look
The next page says: "YOU CONTINUE TO READ THIS BOOK."
The more you read, the more tired you feel.

>look
The next page says: "YOU CONTINUE TO READ THIS BOOK."
You feel drained. It's getting harder to understand the words.

>lok
That's not a verb I recognise.

>look
The next page says: "YOU CONTINUE TO READ THIS BOOK."
In fact, its getting harder to think of anything at all.

>look
The next page says: "YOU CONTINUE TO READ THIS BOOK."
You're exhausted. You feel as if you might pass out soon.

>look
The next page says: "YOU HAVE FINISHED...
The book drops from your hand as you fall asleep mid-sentence, sinking into warm darkness. Time passes, and you awake lying face-down on the carpet in an unfamiliar hallway. There is something strange about this place, but you can't quite explain it. You also sense that something important has changed. You feel a vague but persistent tension growing in the back of your mind. You slowly stand, and after a brief dizzy spell, regain your footing.

Hallway

>read book
You can't see any such thing.

* * *

Welcome
An Interactive Fiction
Release 1 / Serial number 200927 / Inform 7 build 6M62 (I6/v6.33 lib 6/12N) SD

Ordinary Room
You see a white book here.

>read bok
You can't see any such thing.

>take book
Taken.

* * *

>l
testtest

>l
testtest

>wait
testtest

>wait
testtest

>d
testtest

>d
testtest

>d
end test
ACT The Hallway

>d
You can't go that way.

>look
ACT The Hallway

* * *

Welcome
An Interactive Fiction
Release 1 / Serial number 200927 / Inform 7 build 6M62 (I6/v6.33 lib 6/12N) SD

Ordinary Room
You see a white book here.

>close eyes
test